year,msa,firms,estabs,emp,denom,estabs_entry,estabs_entry_rate,estabs_exit,estabs_exit_rate,job_creation,job_creation_births,job_creation_continuers,job_creation_rate_births,job_creation_rate,job_destruction,job_destruction_deaths,job_destruction_continuers,job_destruction_rate_deaths,job_destruction_rate,net_job_creation,net_job_creation_rate,reallocation_rate,firmdeath_firms,firmdeath_estabs,firmdeath_emp
2018,10100,1203,1279,19276,19366,81,6.326,84,6.56,1579,467,1112,2.411,8.153,1759,509,1250,2.628,9.083,-180,-0.929,16.307,60,60,259
2018,10140,1340,1450,15939,15947,118,8.091,135,9.256,1733,344,1389,2.157,10.868,1752,484,1268,3.035,10.987,-19,-0.119,21.735,121,121,436
2018,10180,3121,3690,60338,59493,300,8.15,282,7.661,7340,1885,5455,3.168,12.338,5677,1521,4156,2.557,9.542,1663,2.795,19.085,211,222,1016
2018,10220,835,897,12713,12796,57,6.362,55,6.138,1339,359,980,2.806,10.464,1534,814,720,6.361,11.988,-195,-1.524,20.928,41,41,257
2018,10300,1487,1651,23492,23128,106,6.387,123,7.412,2778,495,2283,2.14,12.011,2061,586,1475,2.534,8.911,717,3.1,17.823,93,94,382
2018,10420,11749,14938,308290,307092,987,6.579,1116,7.439,35787,8097,27690,2.637,11.654,33043,9085,23958,2.958,10.76,2744,0.894,21.52,741,759,5657
2018,10460,807,892,11518,11877,78,8.764,74,8.315,995,325,670,2.736,8.378,1679,771,908,6.492,14.137,-684,-5.759,16.756,49,49,162
2018,10500,2384,2897,46697,47029,179,6.13,225,7.705,4841,1315,3526,2.796,10.294,5478,1376,4102,2.926,11.648,-637,-1.354,20.588,156,156,676
2018,10540,2181,2411,36930,36740,211,8.816,176,7.353,4036,739,3297,2.011,10.985,3668,1133,2535,3.084,9.984,368,1.002,19.968,137,138,742
2018,10580,15657,19621,360517,358035,1650,8.419,1604,8.185,40261,12249,28012,3.421,11.245,35194,10195,24999,2.847,9.83,5067,1.415,19.66,1110,1147,5405
2018,10620,1078,1241,17933,17522,76,6.132,73,5.889,2339,387,1952,2.209,13.349,1469,542,927,3.093,8.384,870,4.965,16.767,55,58,402
2018,10660,646,716,11248,11301,42,5.841,48,6.676,981,241,740,2.133,8.681,1080,314,766,2.779,9.557,-99,-0.876,17.361,38,38,136
2018,10700,1507,1734,32515,32026,113,6.539,101,5.845,3706,585,3121,1.827,11.572,2758,570,2188,1.78,8.612,948,2.96,17.224,78,78,455
2018,10740,13589,17092,308240,306645,1388,8.094,1500,8.747,33981,11206,22775,3.654,11.082,30479,9363,21116,3.053,9.94,3502,1.142,19.879,1052,1072,5811
2018,10780,2633,3067,49095,48918,190,6.156,229,7.419,5389,1476,3913,3.017,11.017,5022,1589,3433,3.248,10.266,367,0.75,20.533,167,176,1154
2018,10820,1153,1219,18079,17945,64,5.188,93,7.54,1629,234,1395,1.304,9.078,1386,404,982,2.251,7.724,243,1.354,15.447,78,78,362
2018,10860,685,773,13845,13716,53,6.825,60,7.727,2384,1034,1350,7.539,17.382,2238,1193,1045,8.698,16.317,146,1.064,32.635,43,43,174
2018,10900,13655,16934,339443,337913,1201,7.066,1325,7.796,36320,9298,27022,2.752,10.748,33489,10999,22490,3.255,9.911,2831,0.838,19.821,916,928,4615
2018,10940,593,664,11096,11163,45,6.662,68,10.067,974,269,705,2.41,8.726,1089,365,724,3.27,9.756,-115,-1.03,17.451,51,51,271
2018,10980,696,745,10209,10188,81,11.134,46,6.323,1329,644,685,6.321,13.045,1233,508,725,4.987,12.103,96,0.942,24.206,30,30,145
2018,11020,2487,2978,53291,53514,160,5.364,170,5.699,4208,872,3336,1.629,7.863,4792,1052,3740,1.966,8.955,-584,-1.091,15.727,126,128,735
2018,11060,452,484,6674,6706,29,5.949,36,7.385,614,191,423,2.848,9.156,680,311,369,4.638,10.14,-66,-0.984,18.312,26,26,95
2018,11100,4990,5863,97518,97560,456,7.774,461,7.86,10841,3334,7507,3.417,11.112,10931,3340,7591,3.424,11.204,-90,-0.092,22.224,338,347,1890
2018,11140,588,629,10004,9703,40,6.339,44,6.973,1371,331,1040,3.411,14.13,758,126,632,1.299,7.812,613,6.318,15.625,38,38,112
2018,11180,1696,1913,31566,31638,139,7.291,126,6.609,3381,980,2401,3.098,10.687,3519,878,2641,2.775,11.123,-138,-0.436,21.373,90,93,686
2018,11220,799,967,15301,15194,71,7.32,77,7.938,1301,393,908,2.587,8.563,1140,358,782,2.356,7.503,161,1.06,15.006,45,45,112
2018,11260,7846,9719,164168,163656,851,8.757,848,8.727,20283,4079,16204,2.492,12.394,19185,4954,14231,3.027,11.723,1098,0.671,23.446,585,594,2334
2018,11380,368,389,5738,5516,51,13.51,28,7.417,1043,424,619,7.687,18.909,563,140,423,2.538,10.207,480,8.702,20.413,21,21,102
2018,11420,830,886,15074,14863,64,7.248,58,6.569,1849,606,1243,4.077,12.44,1425,529,896,3.559,9.588,424,2.853,19.175,46,46,300
2018,11460,6409,7413,159365,157202,638,8.636,587,7.946,17890,4419,13471,2.811,11.38,13540,4136,9404,2.631,8.613,4350,2.767,17.226,416,420,2586
2018,11500,1807,2179,36541,36338,144,6.599,150,6.874,4497,1711,2786,4.709,12.375,4095,884,3211,2.433,11.269,402,1.106,22.538,109,112,524
2018,11540,4588,5479,116659,116447,331,6.017,376,6.834,13389,2385,11004,2.048,11.498,13248,4820,8428,4.139,11.377,141,0.121,22.754,279,287,1796
2018,11580,427,449,5873,5757,44,9.865,38,8.52,862,430,432,7.469,14.973,629,227,402,3.943,10.926,233,4.047,21.852,35,35,210
2018,11620,1370,1490,19887,20091,102,6.8,122,8.133,1890,605,1285,3.011,9.407,2251,764,1487,3.803,11.204,-361,-1.797,18.814,99,99,463
2018,11660,446,494,6887,6898,51,10.559,29,6.004,662,276,386,4.001,9.598,690,168,522,2.436,10.004,-28,-0.406,19.195,21,21,113
2018,11680,612,693,11602,11459,45,6.531,37,5.37,1184,200,984,1.745,10.332,872,193,679,1.684,7.61,312,2.723,15.219,31,31,128
2018,11700,10022,11781,179077,175461,1174,10.064,943,8.084,23571,8019,15552,4.57,13.434,16228,4942,11286,2.817,9.249,7343,4.185,18.498,701,712,3061
2018,11740,879,964,18123,17912,73,7.58,71,7.373,1971,498,1473,2.78,11.004,1545,517,1028,2.886,8.626,426,2.378,17.251,47,47,294
2018,11780,1482,1708,24450,24787,97,5.668,104,6.077,2402,570,1832,2.3,9.691,3026,763,2263,3.078,12.208,-624,-2.517,19.382,64,69,570
2018,11820,1285,1390,15121,14984,124,9.025,92,6.696,1711,473,1238,3.157,11.419,1464,447,1017,2.983,9.771,247,1.648,19.541,67,68,354
2018,11860,317,334,5438,5395,24,7.229,20,6.024,452,117,335,2.169,8.379,364,72,292,1.335,6.748,88,1.631,13.495,17,17,57
2018,11900,837,979,13484,13218,69,7.009,80,8.126,1924,702,1222,5.311,14.556,1396,462,934,3.495,10.561,528,3.995,21.123,48,62,316
2018,11940,763,863,16842,16661,54,6.272,50,5.807,1702,645,1057,3.871,10.215,1365,241,1124,1.446,8.193,337,2.023,16.386,36,37,131
2018,11980,1084,1215,13926,13596,114,9.421,104,8.595,1961,647,1314,4.759,14.424,1339,454,885,3.339,9.849,622,4.575,19.698,84,89,349
2018,12020,3876,4385,69012,67824,398,9.179,300,6.919,9614,3914,5700,5.771,14.175,7130,2031,5099,2.995,10.513,2484,3.662,21.025,215,218,1018
2018,12060,99782,127985,2517129,2481741,13983,10.999,12276,9.656,362539,111413,251126,4.489,14.608,291070,98085,192985,3.952,11.728,71469,2.88,23.457,8821,9045,51635
2018,12100,4717,5572,101293,99631,435,7.764,496,8.853,13001,5393,7608,5.413,13.049,9846,2734,7112,2.744,9.882,3155,3.167,19.765,357,359,1529
2018,12140,799,899,22299,22418,51,5.667,53,5.889,3530,264,3266,1.178,15.746,3800,2085,1715,9.301,16.951,-270,-1.204,31.493,41,41,181
2018,12180,1261,1407,19051,19026,86,6.063,109,7.684,1798,391,1407,2.055,9.45,1763,502,1261,2.639,9.267,35,0.184,18.533,79,80,302
2018,12220,2295,2629,48265,47761,238,9.138,189,7.257,5962,2225,3737,4.659,12.483,5009,1069,3940,2.238,10.488,953,1.995,20.975,141,143,711
2018,12260,7796,9853,190861,190621,750,7.618,733,7.446,23615,8573,15042,4.497,12.388,23129,9978,13151,5.234,12.134,486,0.255,24.267,517,531,2982
2018,12300,2494,2939,49497,49212,188,6.371,212,7.184,5486,759,4727,1.542,11.148,4787,1466,3321,2.979,9.727,699,1.42,19.455,154,163,1062
2018,12380,666,748,13829,13823,43,5.684,60,7.931,1013,276,737,1.997,7.329,985,250,735,1.809,7.126,28,0.203,14.252,42,42,188
2018,12420,38657,48528,882107,862803,5850,12.245,4341,9.087,133563,51518,82045,5.971,15.48,95505,30488,65017,3.534,11.069,38058,4.411,22.138,3260,3314,18912
2018,12460,502,549,6588,6419,41,7.475,40,7.293,814,361,453,5.624,12.681,460,107,353,1.667,7.166,354,5.515,14.332,32,32,87
2018,12540,9682,11870,203316,199687,1181,10.001,1059,8.968,30239,13675,16564,6.848,15.143,23200,10039,13161,5.027,11.618,7039,3.525,23.236,768,779,7401
2018,12580,48458,61136,1213254,1203893,5147,8.424,5073,8.303,140523,41293,99230,3.43,11.672,121736,38398,83338,3.189,10.112,18787,1.561,20.224,3598,3683,22239
2018,12620,3144,3710,56913,56945,239,6.425,259,6.962,5402,861,4541,1.512,9.486,5558,1286,4272,2.258,9.76,-156,-0.274,18.973,186,187,687
2018,12660,1452,1653,31292,31763,103,6.239,99,5.996,2459,450,2009,1.417,7.742,3335,597,2738,1.88,10.5,-876,-2.758,15.484,69,71,365
2018,12680,789,857,14213,14667,58,6.792,52,6.089,1344,218,1126,1.486,9.164,2137,273,1864,1.861,14.571,-793,-5.407,18.327,39,39,98
2018,12700,6352,7283,77181,77579,568,7.774,614,8.404,8437,2233,6204,2.878,10.875,9241,3025,6216,3.899,11.912,-804,-1.036,21.751,427,433,1434
2018,12740,1803,2018,26335,26190,125,6.171,140,6.912,2422,446,1976,1.703,9.248,2162,740,1422,2.826,8.255,260,0.993,16.51,106,108,456
2018,12780,962,1072,18756,19093,66,6.131,75,6.967,1391,505,886,2.645,7.285,2089,880,1209,4.609,10.941,-698,-3.656,14.571,54,56,461
2018,12820,403,429,5600,5593,24,5.575,27,6.272,660,266,394,4.756,11.8,659,261,398,4.667,11.783,1,0.018,23.565,21,21,207
2018,12860,1090,1184,16731,16607,74,6.234,80,6.74,1777,301,1476,1.812,10.7,1529,416,1113,2.505,9.207,248,1.493,18.414,55,55,262
2018,12900,660,723,15531,15234,53,7.336,52,7.197,2127,330,1797,2.166,13.962,1502,480,1022,3.151,9.86,625,4.103,19.719,47,47,433
2018,12940,13685,16957,347977,348217,1445,8.524,1435,8.465,41372,11216,30156,3.221,11.881,42186,11751,30435,3.375,12.115,-814,-0.234,23.762,1011,1075,6637
2018,12980,1963,2301,52919,53094,146,6.29,186,8.014,4229,898,3331,1.691,7.965,4572,1217,3355,2.292,8.611,-343,-0.646,15.93,127,130,604
2018,13020,1690,1963,30203,30024,109,5.516,135,6.832,3037,733,2304,2.441,10.115,2628,778,1850,2.591,8.753,409,1.362,17.506,102,104,516
2018,13060,628,675,8137,8095,45,6.672,44,6.523,913,228,685,2.817,11.279,805,269,536,3.323,9.944,108,1.334,19.889,36,36,238
2018,13100,561,605,7278,7302,26,4.224,47,7.636,683,136,547,1.863,9.354,708,249,459,3.41,9.697,-25,-0.342,18.708,34,34,142
2018,13140,5998,7421,144743,146143,515,6.92,558,7.497,15615,3852,11763,2.636,10.685,18419,3821,14598,2.615,12.603,-2804,-1.919,21.369,392,395,2635
2018,13180,1402,1580,31917,31484,106,6.726,98,6.218,3288,590,2698,1.874,10.444,2456,488,1968,1.55,7.801,832,2.643,15.602,71,75,367
2018,13220,1813,2288,34492,33957,139,6.036,169,7.338,4411,760,3651,2.238,12.99,3365,1245,2120,3.666,9.91,1046,3.08,19.819,129,131,629
2018,13260,754,864,11784,11944,73,8.474,68,7.893,1294,313,981,2.621,10.834,1652,542,1110,4.538,13.832,-358,-2.997,21.669,49,49,376
2018,13300,410,439,5070,4928,33,7.458,40,9.04,814,129,685,2.618,16.518,536,161,375,3.267,10.877,278,5.641,21.753,25,28,100
2018,13340,699,780,18241,18009,42,5.374,45,5.758,1878,293,1585,1.627,10.428,1384,426,958,2.366,7.685,494,2.743,15.371,32,33,264
2018,13380,5471,5958,75922,75402,561,9.464,501,8.451,9131,2539,6592,3.367,12.11,8114,2539,5575,3.367,10.761,1017,1.349,21.522,403,406,1761
2018,13420,958,1087,15275,14774,85,7.87,71,6.574,2434,1061,1373,7.182,16.475,1491,381,1110,2.579,10.092,943,6.383,20.184,52,52,264
2018,13460,5999,6608,71555,70147,840,12.964,583,8.998,11298,4406,6892,6.281,16.106,8544,3051,5493,4.349,12.18,2754,3.926,24.36,440,459,2371
2018,13500,273,299,5022,4881,22,7.346,23,7.679,765,95,670,1.946,15.673,466,234,232,4.794,9.547,299,6.126,19.094,19,19,82
2018,13540,1137,1231,15420,15267,70,5.643,89,7.175,1654,213,1441,1.395,10.834,1301,419,882,2.744,8.522,353,2.312,17.043,63,63,233
2018,13620,737,851,9211,9307,56,6.612,48,5.667,820,229,591,2.461,8.811,970,394,576,4.233,10.422,-150,-1.612,17.621,39,39,309
2018,13660,601,643,9410,9533,47,7.281,52,8.056,1118,264,854,2.769,11.728,1359,517,842,5.424,14.256,-241,-2.528,23.457,42,42,389
2018,13700,671,733,9535,9394,62,8.546,47,6.478,1447,480,967,5.11,15.404,1168,416,752,4.429,12.434,279,2.97,24.868,33,33,266
2018,13720,802,1013,14042,13964,47,4.552,86,8.329,1820,708,1112,5.07,13.034,1638,444,1194,3.18,11.73,182,1.303,23.46,56,56,168
2018,13740,4736,5400,75802,80494,435,8.054,437,8.091,7701,2435,5266,3.025,9.567,17941,1855,16086,2.305,22.289,-10240,-12.721,19.134,328,330,1301
2018,13780,3734,4543,79258,79372,314,6.892,340,7.463,6841,1329,5512,1.674,8.619,7055,1792,5263,2.258,8.889,-214,-0.27,17.238,239,239,871
2018,13820,18868,24153,481131,475024,1820,7.537,1812,7.503,58752,18492,40260,3.893,12.368,46885,15096,31789,3.178,9.87,11867,2.498,19.74,1236,1303,8227
2018,13900,3173,3588,59825,59315,278,7.729,296,8.229,6757,1370,5387,2.31,11.392,5876,1333,4543,2.247,9.907,881,1.485,19.813,227,232,984
2018,13940,742,793,10379,10056,72,9.219,48,6.146,1405,320,1085,3.182,13.972,757,162,595,1.611,7.528,648,6.444,15.056,43,43,132
2018,13980,2705,3222,52270,51796,203,6.307,196,6.09,5394,917,4477,1.77,10.414,4445,880,3565,1.699,8.582,949,1.832,17.163,142,144,543
2018,14010,3106,3660,78795,77580,226,6.14,268,7.281,9405,3183,6222,4.103,12.123,7129,1462,5667,1.885,9.189,2276,2.934,18.378,184,197,918
2018,14020,2611,3183,55075,54414,298,9.436,248,7.853,6905,2235,4670,4.107,12.69,5484,2018,3466,3.709,10.078,1421,2.611,20.157,157,163,1023
2018,14100,1389,1735,37457,37182,88,5.037,112,6.411,3071,1107,1964,2.977,8.259,2551,573,1978,1.541,6.861,520,1.399,13.722,74,74,304
2018,14140,1640,2022,29006,28874,120,5.879,158,7.741,2920,889,2031,3.079,10.113,2631,1072,1559,3.713,9.112,289,1.001,18.224,116,127,664
2018,14180,628,733,16370,16207,36,4.862,51,6.887,1378,315,1063,1.944,8.503,1017,338,679,2.086,6.275,361,2.228,12.551,40,40,257
2018,14220,525,597,8604,8820,42,7.029,43,7.197,778,243,535,2.755,8.821,1205,370,835,4.195,13.662,-427,-4.841,17.642,31,33,256
2018,14260,14151,16941,271829,265513,2090,12.606,1366,8.239,45468,16645,28823,6.269,17.125,32532,11544,20988,4.348,12.253,12936,4.872,24.505,1000,1018,5711
2018,14340,494,523,6872,6946,40,7.759,25,4.85,577,104,473,1.497,8.308,726,134,592,1.929,10.453,-149,-2.145,16.615,20,20,63
2018,14380,1373,1468,18376,18252,141,9.711,109,7.507,2302,809,1493,4.432,12.612,2022,905,1117,4.958,11.078,280,1.534,22.156,86,87,602
2018,14420,384,422,6136,6166,30,7.092,32,7.565,459,129,330,2.092,7.445,520,164,356,2.66,8.434,-61,-0.989,14.889,26,26,102
2018,14460,94369,119119,2611588,2577120,9965,8.386,9392,7.904,322951,102764,220187,3.988,12.531,251696,76819,174877,2.981,9.767,71255,2.765,19.533,6702,6817,39361
2018,14500,9924,10943,155147,154096,1242,11.444,1061,9.777,20279,7268,13011,4.717,13.16,18196,6876,11320,4.462,11.808,2083,1.352,23.616,810,813,4017
2018,14540,2626,3124,63616,63517,212,6.64,350,10.961,7730,3246,4484,5.11,12.17,7459,2852,4607,4.49,11.743,271,0.427,23.487,288,288,1844
2018,14580,4521,4776,48496,47722,619,13.187,455,9.693,7158,2751,4407,5.765,14.999,5655,1990,3665,4.17,11.85,1503,3.149,23.7,351,356,1561
2018,14620,777,906,12300,12222,54,5.997,43,4.775,1182,228,954,1.865,9.671,1022,234,788,1.915,8.362,160,1.309,16.724,30,30,180
2018,14660,2312,2654,33343,33198,180,6.782,180,6.782,3282,811,2471,2.443,9.886,2982,748,2234,2.253,8.982,300,0.904,17.965,123,129,497
2018,14700,1950,2238,29776,29552,230,10.339,203,9.126,4313,1426,2887,4.825,14.595,3901,1582,2319,5.353,13.201,412,1.394,26.401,158,160,1042
2018,14720,1668,1815,22623,22179,199,10.985,192,10.599,2717,803,1914,3.621,12.25,1807,785,1022,3.539,8.147,910,4.103,16.295,143,144,656
2018,14740,4553,5184,61776,60355,506,9.832,431,8.375,8710,3067,5643,5.082,14.431,5874,2022,3852,3.35,9.732,2836,4.699,19.465,322,325,1234
2018,14780,780,842,12366,12199,77,9.266,55,6.619,1405,459,946,3.763,11.517,1080,385,695,3.156,8.853,325,2.664,17.706,39,39,314
2018,14820,734,769,7915,7856,76,10.04,52,6.869,907,243,664,3.093,11.546,785,220,565,2.801,9.993,122,1.553,19.986,40,40,126
2018,14860,20165,24341,425536,427030,2112,8.667,2165,8.885,51710,17552,34158,4.11,12.109,54645,18090,36555,4.236,12.797,-2935,-0.687,24.218,1568,1582,9395
2018,15020,726,773,11048,10897,52,6.793,37,4.833,1072,187,885,1.716,9.838,776,134,642,1.23,7.121,296,2.716,14.242,27,27,90
2018,15060,590,644,5494,5503,72,11.312,57,8.955,674,307,367,5.579,12.248,683,283,400,5.143,12.411,-9,-0.164,24.496,48,48,251
2018,15100,764,817,13883,13982,55,6.691,65,7.908,1196,176,1020,1.259,8.554,1434,184,1250,1.316,10.256,-238,-1.702,17.108,49,49,118
2018,15180,4731,6054,109649,108759,537,8.939,444,7.391,15041,5204,9837,4.785,13.83,13414,2870,10544,2.639,12.334,1627,1.496,24.667,321,336,1941
2018,15220,758,822,13178,13328,54,6.522,66,7.971,999,233,766,1.748,7.496,1349,294,1055,2.206,10.122,-350,-2.626,14.992,58,58,220
2018,15260,2419,2687,37219,37041,240,8.999,200,7.499,4510,1122,3388,3.029,12.176,4157,1340,2817,3.618,11.223,353,0.953,22.445,153,157,980
2018,15340,678,736,12715,12525,38,5.104,55,7.388,1452,452,1000,3.609,11.593,1096,320,776,2.555,8.75,356,2.842,17.501,32,32,185
2018,15380,19722,24882,494521,491528,1880,7.529,2059,8.245,53961,14373,39588,2.924,10.978,48143,15833,32310,3.221,9.795,5818,1.184,19.589,1465,1512,8746
2018,15420,929,998,13112,12963,84,8.554,52,5.295,1559,378,1181,2.916,12.027,1251,225,1026,1.736,9.651,308,2.376,19.302,38,40,158
2018,15460,983,1142,20469,20663,59,5.126,77,6.69,1584,404,1180,1.955,7.666,1976,524,1452,2.536,9.563,-392,-1.897,15.332,52,53,291
2018,15500,2627,3078,60751,59888,267,8.733,226,7.392,8974,3771,5203,6.297,14.985,7219,3960,3259,6.612,12.054,1755,2.93,24.108,164,170,989
2018,15540,5388,6208,103773,103492,454,7.315,451,7.267,10068,2790,7278,2.696,9.728,9635,2738,6897,2.646,9.31,433,0.418,18.62,317,318,1785
2018,15580,947,1043,12903,12811,84,8.092,74,7.129,1414,407,1007,3.177,11.038,1228,291,937,2.272,9.586,186,1.452,19.172,59,59,243
2018,15620,967,1058,15142,14942,81,7.689,72,6.834,1820,711,1109,4.759,12.181,1448,310,1138,2.075,9.691,372,2.49,19.382,60,60,276
2018,15660,894,967,19833,19814,84,8.759,68,7.091,2371,1262,1109,6.369,11.967,2370,417,1953,2.105,11.962,1,0.005,23.923,54,54,271
2018,15680,1577,1854,33003,32684,153,8.277,142,7.682,4540,1627,2913,4.978,13.891,3803,798,3005,2.442,11.636,737,2.255,23.271,82,85,449
2018,15700,585,629,9505,9633,39,6.171,45,7.12,807,244,563,2.533,8.377,1018,294,724,3.052,10.568,-211,-2.19,16.755,32,32,234
2018,15740,708,802,13740,13792,48,5.974,51,6.347,1265,286,979,2.074,9.172,1366,275,1091,1.994,9.904,-101,-0.732,18.344,31,32,190
2018,15780,472,521,8189,8180,23,4.381,31,5.905,768,106,662,1.296,9.389,716,138,578,1.687,8.754,52,0.636,17.507,28,28,127
2018,15820,489,523,10437,10155,33,6.244,44,8.325,1168,117,1051,1.152,11.502,636,154,482,1.517,6.263,532,5.239,12.526,30,30,112
2018,15860,737,783,8229,8143,62,7.878,70,8.895,918,281,637,3.451,11.274,762,275,487,3.377,9.358,156,1.916,18.717,50,54,242
2018,15900,530,568,5985,6114,33,5.719,51,8.839,683,255,428,4.171,11.171,915,388,527,6.346,14.966,-232,-3.795,22.342,45,45,267
2018,15940,6484,7954,150909,150296,505,6.332,548,6.871,16039,4304,11735,2.864,10.672,14601,4985,9616,3.317,9.715,1438,0.957,19.43,400,408,2689
2018,15980,14340,16788,227275,223923,1932,11.598,1673,10.043,31605,11372,20233,5.079,14.114,25142,9427,15715,4.21,11.228,6463,2.886,22.456,1291,1321,5453
2018,16020,2160,2446,39428,39609,177,7.205,198,8.06,3429,834,2595,2.106,8.657,3834,983,2851,2.482,9.68,-405,-1.022,17.314,161,163,843
2018,16060,2185,2646,41662,41973,138,5.159,196,7.327,4422,672,3750,1.601,10.535,5053,1103,3950,2.628,12.039,-631,-1.503,21.071,152,156,793
2018,16100,1201,1374,23747,23098,131,9.629,104,7.644,4100,1477,2623,6.394,17.75,2820,863,1957,3.736,12.209,1280,5.542,24.418,79,80,368
2018,16180,1559,1695,21898,21404,184,10.972,148,8.825,3356,1095,2261,5.116,15.679,2318,936,1382,4.373,10.83,1038,4.85,21.66,111,116,549
2018,16220,2440,2691,31910,31537,252,9.377,245,9.116,4392,1346,3046,4.268,13.926,3606,1240,2366,3.932,11.434,786,2.492,22.868,174,177,586
2018,16260,1180,1246,14235,13802,171,14.097,105,8.656,2069,830,1239,6.014,14.991,1220,318,902,2.304,8.84,849,6.152,17.679,80,80,220
2018,16300,5044,6189,126911,127951,476,7.748,385,6.267,11350,3249,8101,2.539,8.871,13448,2276,11172,1.779,10.51,-2098,-1.64,17.741,276,285,1298
2018,16340,505,556,10508,10491,41,7.321,49,8.75,935,174,761,1.659,8.913,884,255,629,2.431,8.427,51,0.486,16.853,30,31,148
2018,16380,845,919,16701,16296,44,4.777,48,5.212,1854,583,1271,3.578,11.377,1010,192,818,1.178,6.198,844,5.179,12.396,39,39,147
2018,16460,732,804,11089,11208,36,4.412,60,7.353,893,182,711,1.624,7.968,1111,281,830,2.507,9.913,-218,-1.945,15.935,47,47,248
2018,16500,1555,1707,20909,21024,142,8.328,138,8.094,2590,788,1802,3.748,12.32,2818,1005,1813,4.78,13.404,-228,-1.085,24.639,103,103,684
2018,16540,2454,2880,51960,51559,179,6.213,181,6.283,5600,1056,4544,2.048,10.861,4785,1049,3736,2.035,9.281,815,1.581,18.561,126,126,768
2018,16580,3813,4552,76511,76227,376,8.311,320,7.073,8821,2458,6363,3.225,11.572,8248,2018,6230,2.647,10.82,573,0.752,21.641,221,227,1165
2018,16620,3702,4783,87204,86623,292,6.063,358,7.434,10291,3151,7140,3.638,11.88,9025,2752,6273,3.177,10.419,1266,1.462,20.838,240,244,1616
2018,16660,1024,1245,21667,21392,63,5.038,74,5.918,3146,362,2784,1.692,14.706,2442,601,1841,2.809,11.415,704,3.291,22.831,56,57,442
2018,16700,14388,17802,307907,303272,1882,10.688,1496,8.496,40961,13767,27194,4.539,13.506,31965,9756,22209,3.217,10.54,8996,2.966,21.08,1087,1106,5768
2018,16740,43420,56187,1098361,1086610,5791,10.391,4879,8.755,147289,47536,99753,4.375,13.555,124496,44087,80409,4.057,11.457,22793,2.098,22.915,3469,3555,21456
2018,16820,4987,5692,86994,86636,469,8.27,427,7.53,9262,2873,6389,3.316,10.691,8584,2939,5645,3.392,9.908,678,0.783,19.816,321,323,2063
2018,16860,8509,10749,230828,228958,794,7.401,754,7.028,24395,5575,18820,2.435,10.655,20420,5331,15089,2.328,8.919,3975,1.736,17.837,544,557,3571
2018,16940,2663,2899,34215,33521,345,11.996,299,10.396,5072,2071,3001,6.178,15.131,3708,1501,2207,4.478,11.062,1364,4.069,22.124,218,221,957
2018,16980,174085,217252,4318942,4294078,19579,9.021,19143,8.82,534622,169697,364925,3.952,12.45,483533,139575,343958,3.25,11.26,51089,1.19,22.521,13879,14213,74602
2018,17020,3782,4355,64314,63725,367,8.477,316,7.299,7114,1951,5163,3.062,11.164,6042,1593,4449,2.5,9.481,1072,1.682,18.963,245,247,983
2018,17060,967,1122,23515,23520,72,6.397,79,7.019,2634,544,2090,2.313,11.199,2626,971,1655,4.128,11.165,8,0.034,22.33,57,61,812
2018,17140,31666,43000,1015373,1003338,3286,7.646,3244,7.548,128005,40545,87460,4.041,12.758,104582,29656,74926,2.956,10.423,23423,2.335,20.847,2099,2167,13688
2018,17200,5055,5862,90049,89499,432,7.378,418,7.139,7834,1799,6035,2.01,8.753,6851,2199,4652,2.457,7.655,983,1.098,15.31,326,329,1516
2018,17220,1644,1969,33592,32965,140,7.078,158,7.988,4757,1475,3282,4.474,14.43,3584,943,2641,2.861,10.872,1173,3.558,21.744,114,116,480
2018,17260,453,493,5694,5791,32,6.517,28,5.703,488,119,369,2.055,8.428,697,172,525,2.97,12.037,-209,-3.609,16.855,15,15,46
2018,17300,3403,4214,73521,72772,377,9.051,280,6.722,8288,2649,5639,3.64,11.389,6837,1762,5075,2.421,9.395,1451,1.994,18.79,187,199,972
2018,17340,907,1004,9804,9726,91,9.055,93,9.254,1087,331,756,3.403,11.176,926,300,626,3.085,9.521,161,1.655,19.042,87,87,287
2018,17380,610,654,8935,9129,38,5.775,46,6.991,664,194,470,2.125,7.274,1067,333,734,3.648,11.688,-403,-4.415,14.547,38,38,156
2018,17420,1699,1986,42183,42254,139,7.008,134,6.756,4271,743,3528,1.758,10.108,4420,1712,2708,4.052,10.461,-149,-0.353,20.216,104,104,1302
2018,17460,35045,45796,944948,941862,3087,6.702,3614,7.846,97516,25744,71772,2.733,10.354,91353,29661,61692,3.149,9.699,6163,0.654,19.398,2421,2524,17085
2018,17500,494,529,7687,7328,42,7.858,53,9.916,1322,189,1133,2.579,18.04,624,234,390,3.193,8.515,698,9.525,17.031,42,42,157
2018,17540,917,1032,17083,17463,68,6.564,76,7.336,1265,478,787,2.737,7.244,2002,441,1561,2.525,11.465,-737,-4.22,14.488,57,57,269
2018,17580,861,951,12366,12413,67,6.997,80,8.355,1559,737,822,5.938,12.56,1649,455,1194,3.666,13.285,-90,-0.725,25.12,58,58,166
2018,17660,4012,4377,55537,54558,536,12.465,382,8.884,7530,2581,4949,4.731,13.802,5568,1850,3718,3.391,10.206,1962,3.596,20.411,305,306,1135
2018,17700,628,734,12724,12572,31,4.184,45,6.073,1154,165,989,1.312,9.179,891,189,702,1.503,7.087,263,2.092,14.174,37,37,150
2018,17740,687,759,11480,11385,46,6.105,35,4.645,1114,452,662,3.97,9.785,967,129,838,1.133,8.494,147,1.291,16.988,28,28,83
2018,17780,3974,4642,76369,75927,437,9.488,365,7.924,9994,3569,6425,4.701,13.163,9112,2882,6230,3.796,12.001,882,1.162,24.002,266,271,1369
2018,17820,13391,16193,253172,250998,1819,11.34,1515,9.445,32825,11113,21712,4.428,13.078,28472,9328,19144,3.716,11.344,4353,1.734,22.687,1077,1088,5125
2018,17860,3693,4242,78285,78925,358,8.435,362,8.53,8296,1862,6434,2.359,10.511,9494,1941,7553,2.459,12.029,-1198,-1.518,21.023,271,273,1060
2018,17900,12639,16185,311527,305932,1338,8.284,1273,7.881,42521,11967,30554,3.912,13.899,31671,11310,20361,3.697,10.352,10850,3.547,20.705,817,884,6311
2018,17980,4192,5285,99741,99363,382,7.187,443,8.334,10413,3350,7063,3.371,10.48,9741,2952,6789,2.971,9.803,672,0.676,19.607,301,311,1628
2018,18020,1498,1751,47261,47751,121,6.924,114,6.524,4357,962,3395,2.015,9.125,5336,1512,3824,3.166,11.175,-979,-2.05,18.249,69,71,632
2018,18060,1245,1376,21012,21193,98,7.112,102,7.402,2184,649,1535,3.062,10.306,2548,626,1922,2.954,12.023,-364,-1.718,20.611,82,83,420
2018,18100,898,971,16737,16657,61,6.341,43,4.47,1156,378,778,2.269,6.94,997,223,774,1.339,5.985,159,0.955,11.971,39,39,216
2018,18140,29046,39587,917805,902164,3507,8.918,2982,7.583,123310,35667,87643,3.953,13.668,91618,28954,62664,3.209,10.155,31692,3.513,20.311,2040,2123,14273
2018,18180,3332,3765,64110,64355,262,6.958,263,6.984,6300,2245,4055,3.488,9.79,6924,1826,5098,2.837,10.759,-624,-0.97,19.579,190,190,642
2018,18220,363,400,5161,5335,22,5.412,35,8.61,509,115,394,2.156,9.541,832,332,500,6.223,15.595,-323,-6.054,19.082,17,17,116
2018,18260,1851,2107,35449,35183,153,7.27,148,7.033,3880,991,2889,2.817,11.028,3399,756,2643,2.149,9.661,481,1.367,19.322,120,125,512
2018,18300,1287,1445,18435,18364,126,8.762,112,7.789,1821,484,1337,2.636,9.916,1663,426,1237,2.32,9.056,158,0.86,18.112,85,85,274
2018,18380,424,473,7192,7029,31,6.547,32,6.758,897,190,707,2.703,12.761,566,206,360,2.931,8.052,331,4.709,16.105,18,18,65
2018,18420,674,722,12418,12430,51,7.044,55,7.597,1178,229,949,1.842,9.477,1143,245,898,1.971,9.196,35,0.282,18.392,41,41,180
2018,18460,718,779,12238,12209,61,7.891,49,6.339,1280,349,931,2.859,10.484,1174,390,784,3.194,9.616,106,0.868,19.233,41,41,326
2018,18500,1387,1648,26681,26697,115,6.993,108,6.567,2238,609,1629,2.281,8.383,2240,492,1748,1.843,8.39,-2,-0.007,16.766,81,81,372
2018,18580,7105,8975,166981,166294,777,8.67,750,8.369,22848,6294,16554,3.785,13.74,21380,6098,15282,3.667,12.857,1468,0.883,25.714,519,538,3414
2018,18620,800,892,13616,13662,55,6.166,55,6.166,1227,292,935,2.137,8.981,1339,187,1152,1.369,9.801,-112,-0.82,17.963,45,45,156
2018,18660,819,931,15270,15135,66,7.078,69,7.399,1775,327,1448,2.161,11.728,1542,411,1131,2.716,10.189,233,1.54,20.377,53,53,218
2018,18700,1812,1982,31299,29822,154,7.786,146,7.381,5192,2665,2527,8.937,17.41,2364,804,1560,2.696,7.927,2828,9.483,15.854,115,115,488
2018,18740,537,582,8601,8700,32,5.424,48,8.136,1243,262,981,3.012,14.288,1432,709,723,8.15,16.461,-189,-2.173,28.576,37,38,246
2018,18780,339,351,3436,3331,34,9.7,33,9.415,541,125,416,3.753,16.244,316,101,215,3.033,9.488,225,6.756,18.976,28,28,87
2018,18820,705,793,13441,13258,36,4.483,56,6.974,1228,141,1087,1.064,9.263,849,168,681,1.267,6.404,379,2.859,12.808,45,45,130
2018,18860,331,360,4041,4024,23,6.336,29,7.989,365,86,279,2.137,9.071,337,107,230,2.659,8.375,28,0.696,16.75,19,19,36
2018,18880,5846,7010,87497,87529,761,10.935,660,9.483,12742,4987,7755,5.698,14.558,12726,5219,7507,5.963,14.539,16,0.018,29.079,462,480,3385
2018,18900,929,1012,15842,15407,100,10.101,56,5.657,1849,515,1334,3.343,12.001,947,187,760,1.214,6.147,902,5.855,12.294,47,47,152
2018,18980,1481,1637,24891,25019,105,6.42,102,6.237,2205,479,1726,1.915,8.813,2447,433,2014,1.731,9.781,-242,-0.967,17.627,87,88,312
2018,19000,822,875,11875,11699,78,8.955,70,8.037,1300,434,866,3.71,11.112,966,279,687,2.385,8.257,334,2.855,16.514,50,50,228
2018,19060,1554,1845,29890,29807,103,5.565,115,6.213,3004,573,2431,1.922,10.078,2795,560,2235,1.879,9.377,209,0.701,18.754,91,91,301
2018,19100,114108,150483,3277875,3250707,16296,10.912,14003,9.377,445595,145842,299753,4.486,13.708,392841,135374,257467,4.164,12.085,52754,1.623,24.17,10034,10328,75626
2018,19140,2086,2421,56531,56771,186,7.67,194,8,6108,1076,5032,1.895,10.759,6665,1821,4844,3.208,11.74,-557,-0.981,21.518,153,155,1026
2018,19180,1065,1281,23519,23769,59,4.533,100,7.683,2098,510,1588,2.146,8.827,2620,660,1960,2.777,11.023,-522,-2.196,17.653,73,75,278
2018,19220,867,965,17876,17608,58,5.986,66,6.811,1902,459,1443,2.607,10.802,1337,466,871,2.647,7.593,565,3.209,15.186,49,49,379
2018,19260,1728,1979,32493,32610,109,5.482,128,6.437,3083,974,2109,2.987,9.454,3312,1051,2261,3.223,10.157,-229,-0.702,18.909,101,108,953
2018,19300,4256,4984,64853,63446,471,9.55,367,7.441,10013,3024,6989,4.766,15.782,7275,2292,4983,3.613,11.467,2738,4.316,22.933,284,287,1452
2018,19340,6450,8131,164541,162211,515,6.305,590,7.223,19854,4229,15625,2.607,12.24,15655,3868,11787,2.385,9.651,4199,2.589,19.302,421,432,2828
2018,19380,11385,15266,330816,331212,989,6.452,1116,7.28,37531,10134,27397,3.06,11.331,38617,11549,27068,3.487,11.659,-1086,-0.328,22.663,754,784,5212
2018,19420,435,472,8663,8770,38,8.146,27,5.788,1078,461,617,5.257,12.293,1295,268,1027,3.056,14.767,-217,-2.474,24.585,20,20,126
2018,19460,2428,2826,49815,49028,187,6.607,196,6.925,6566,1171,5395,2.388,13.392,5170,1744,3426,3.557,10.545,1396,2.847,21.09,145,150,1240
2018,19500,1853,2207,44303,44349,130,5.83,176,7.892,4225,1036,3189,2.336,9.527,4241,1646,2595,3.711,9.563,-16,-0.036,19.053,125,128,1055
2018,19540,631,681,12665,12706,38,5.576,39,5.723,937,141,796,1.11,7.375,1040,542,498,4.266,8.185,-103,-0.811,14.75,29,29,125
2018,19580,683,761,13334,13319,38,5.017,31,4.092,1191,174,1017,1.306,8.942,1167,151,1016,1.134,8.762,24,0.18,17.524,26,26,138
2018,19620,683,753,11320,11100,61,8.112,59,7.846,1280,512,768,4.613,11.532,843,276,567,2.486,7.595,437,3.937,15.189,45,45,182
2018,19660,11566,13624,174423,172033,1421,10.497,1247,9.212,25031,9771,15260,5.68,14.55,20132,7188,12944,4.178,11.702,4899,2.848,23.405,955,979,4932
2018,19700,318,349,4437,4427,24,6.78,34,9.605,388,80,308,1.807,8.765,379,120,259,2.711,8.562,9,0.203,17.124,24,24,70
2018,19740,60367,74777,1390121,1371490,8507,11.452,7522,10.126,194056,63956,130100,4.663,14.149,157059,53001,104058,3.864,11.452,36997,2.698,22.903,5413,5505,32027
2018,19760,521,564,6594,6643,42,7.42,46,8.127,593,154,439,2.318,8.927,686,223,463,3.357,10.327,-93,-1.4,17.853,36,36,156
2018,19780,11879,15192,350581,346535,1458,9.722,1067,7.115,38564,11687,26877,3.373,11.128,30625,9150,21475,2.64,8.838,7939,2.291,17.675,761,786,4227
2018,19820,71495,89916,1897291,1858754,7651,8.525,7325,8.161,270286,72036,198250,3.876,14.541,191119,62657,128462,3.371,10.282,79167,4.259,20.564,5459,5626,38068
2018,19860,980,1066,14699,14433,96,9.048,86,8.106,2220,718,1502,4.975,15.381,1692,519,1173,3.596,11.723,528,3.658,23.446,63,64,364
2018,19940,587,655,10637,10728,30,4.573,32,4.878,886,161,725,1.501,8.259,1044,111,933,1.035,9.732,-158,-1.473,16.518,25,25,95
2018,19980,666,730,14301,14142,43,5.907,39,5.357,1226,202,1024,1.428,8.669,876,183,693,1.294,6.194,350,2.475,12.389,25,25,115
2018,20020,2697,3166,52621,52282,184,5.776,223,7,5522,1497,4025,2.863,10.562,4871,1239,3632,2.37,9.317,651,1.245,18.634,169,171,1025
2018,20060,712,776,14286,13939,48,6.202,44,5.685,1678,416,1262,2.984,12.038,972,162,810,1.162,6.973,706,5.065,13.946,31,31,106
2018,20100,2799,3280,54767,54116,421,13.117,280,8.724,6973,3054,3919,5.643,12.885,5638,1564,4074,2.89,10.418,1335,2.467,20.837,200,202,794
2018,20140,979,1094,16782,16509,74,6.761,75,6.852,2120,510,1610,3.089,12.841,1522,378,1144,2.29,9.219,598,3.622,18.438,53,54,275
2018,20180,1523,1796,25419,25668,110,6.084,134,7.412,2500,561,1939,2.186,9.74,2986,797,2189,3.105,11.633,-486,-1.893,19.48,96,96,429
2018,20220,2156,2536,56036,55348,146,5.744,158,6.216,5497,1081,4416,1.953,9.932,4112,748,3364,1.351,7.429,1385,2.502,14.859,123,126,597
2018,20260,5144,6422,110389,110765,381,5.911,428,6.64,10443,2432,8011,2.196,9.428,11266,2831,8435,2.556,10.171,-823,-0.743,18.856,322,328,1560
2018,20300,397,422,8007,7964,28,6.659,25,5.945,637,175,462,2.198,7.999,564,83,481,1.042,7.082,73,0.917,14.165,13,13,47
2018,20340,934,1020,11637,11762,78,7.632,82,8.023,1384,438,946,3.724,11.767,1664,406,1258,3.452,14.148,-280,-2.381,23.534,64,66,252
2018,20380,1416,1590,21885,21948,141,8.975,103,6.556,2274,614,1660,2.798,10.361,2411,750,1661,3.417,10.985,-137,-0.624,20.722,88,88,658
2018,20420,1992,2091,22486,21899,198,9.526,173,8.323,3798,592,3206,2.703,17.343,2532,674,1858,3.078,11.562,1266,5.781,23.124,135,135,533
2018,20460,670,742,10724,10447,63,8.618,41,5.609,1329,348,981,3.331,12.721,797,222,575,2.125,7.629,532,5.092,15.258,32,32,128
2018,20500,9788,11808,267229,263386,1177,10.045,995,8.492,30199,10328,19871,3.921,11.466,22781,6876,15905,2.611,8.649,7418,2.816,17.299,717,727,4030
2018,20540,679,731,13246,13190,41,5.578,49,6.667,1506,299,1207,2.267,11.418,1432,413,1019,3.131,10.857,74,0.561,21.713,30,31,318
2018,20580,685,761,12489,12555,55,7.256,49,6.464,979,340,639,2.708,7.798,1098,195,903,1.553,8.746,-119,-0.948,15.595,42,43,185
2018,20660,1243,1341,17751,17869,97,7.293,75,5.639,1546,341,1205,1.908,8.652,1814,502,1312,2.809,10.152,-268,-1.5,17.304,61,61,349
2018,20700,2653,3009,47599,48373,254,8.416,272,9.013,5467,2146,3321,4.436,11.302,6924,2758,4166,5.702,14.314,-1457,-3.012,22.604,200,200,1663
2018,20740,3273,3884,75568,74059,292,7.528,282,7.27,9997,2047,7950,2.764,13.499,7038,2469,4569,3.334,9.503,2959,3.995,19.007,202,205,1510
2018,20780,2623,2865,33761,33179,296,10.375,272,9.534,4314,940,3374,2.833,13.002,3110,1400,1710,4.22,9.374,1204,3.629,18.747,219,220,1196
2018,20820,1033,1150,26691,26281,74,6.48,58,5.079,2078,615,1463,2.34,7.907,1301,258,1043,0.982,4.95,777,2.957,9.901,46,46,192
2018,20900,854,940,11367,11253,59,6.273,60,6.38,1262,324,938,2.879,11.215,1044,284,760,2.524,9.278,218,1.937,18.556,51,51,213
2018,20940,1948,2348,32773,32394,206,8.783,201,8.57,4035,1457,2578,4.498,12.456,3216,1049,2167,3.238,9.928,819,2.528,19.856,145,150,783
2018,20980,898,996,16059,15846,48,4.755,75,7.429,2060,722,1338,4.556,13.001,1699,349,1350,2.203,10.722,361,2.278,21.445,61,61,304
2018,21020,999,1114,12904,12929,82,7.27,110,9.752,1685,696,989,5.383,13.033,1727,710,1017,5.492,13.358,-42,-0.325,26.066,72,73,342
2018,21060,2063,2442,42676,42741,176,7.216,170,6.97,4431,1473,2958,3.446,10.367,4471,1267,3204,2.964,10.461,-40,-0.094,20.734,127,132,410
2018,21120,660,714,8826,8619,59,8.275,57,7.994,1443,407,1036,4.722,16.743,1061,448,613,5.198,12.311,382,4.432,24.621,38,38,313
2018,21140,3854,4611,144498,139373,321,6.978,300,6.521,21769,4205,17564,3.017,15.619,11907,3442,8465,2.47,8.543,9862,7.076,17.087,223,223,1967
2018,21180,557,611,9245,9243,37,6.031,42,6.846,852,230,622,2.488,9.218,859,315,544,3.408,9.294,-7,-0.076,18.436,31,31,149
2018,21220,964,1058,22350,22008,72,6.748,90,8.435,2615,1059,1556,4.812,11.882,1953,1019,934,4.63,8.874,662,3.008,17.748,66,66,894
2018,21260,1076,1134,12068,11910,130,11.717,81,7.301,1525,505,1020,4.24,12.805,1224,323,901,2.712,10.278,301,2.527,20.555,63,63,240
2018,21300,1369,1632,31067,30751,103,6.329,94,5.776,2898,809,2089,2.631,9.424,2245,534,1711,1.737,7.301,653,2.124,14.601,65,65,385
2018,21340,10474,13698,252442,248927,1342,9.884,1100,8.102,34655,11525,23130,4.63,13.922,27116,7466,19650,2.999,10.893,7539,3.029,21.786,797,814,4616
2018,21380,698,774,12277,11963,41,5.23,61,7.781,1811,749,1062,6.261,15.139,1224,606,618,5.066,10.232,587,4.907,20.464,49,49,544
2018,21420,1361,1520,21418,21426,77,5.026,101,6.593,2225,478,1747,2.231,10.385,2187,730,1457,3.407,10.207,38,0.177,20.415,76,76,372
2018,21460,847,912,13723,13763,64,6.987,72,7.86,1248,322,926,2.34,9.068,1309,323,986,2.347,9.511,-61,-0.443,18.136,54,54,240
2018,21500,4566,5769,116931,116350,355,6.169,327,5.682,12314,3713,8601,3.191,10.584,11022,3435,7587,2.952,9.473,1292,1.11,18.946,228,230,1125
2018,21540,839,909,11879,11794,68,7.468,71,7.798,1289,275,1014,2.332,10.93,1102,451,651,3.824,9.344,187,1.586,18.688,52,52,240
2018,21580,450,496,5899,5966,39,7.895,35,7.085,646,135,511,2.263,10.828,777,153,624,2.565,13.024,-131,-2.196,21.656,26,26,125
2018,21660,7759,9055,127586,126469,787,8.716,736,8.151,15313,3732,11581,2.951,12.108,12957,3721,9236,2.942,10.245,2356,1.863,20.49,576,579,2363
2018,21700,2547,2933,35442,35200,215,7.34,207,7.067,4225,1009,3216,2.866,12.003,3724,1115,2609,3.168,10.58,501,1.423,21.159,159,160,700
2018,21740,476,511,7527,7124,57,11.321,42,8.342,1310,238,1072,3.341,18.39,479,118,361,1.656,6.724,831,11.666,13.448,32,32,63
2018,21780,5675,7208,146891,146132,455,6.312,455,6.312,14628,3439,11189,2.353,10.01,12998,3618,9380,2.476,8.895,1630,1.115,17.789,312,322,2190
2018,21820,1879,2151,26505,26746,175,8.145,170,7.912,2572,663,1909,2.479,9.616,3008,743,2265,2.778,11.247,-436,-1.63,19.233,121,124,478
2018,21840,533,556,7195,7147,46,8.311,41,7.407,898,305,593,4.268,12.565,822,406,416,5.681,11.501,76,1.063,23.003,31,31,305
2018,21900,919,1058,14970,14866,60,5.594,89,8.298,2304,482,1822,3.242,15.499,2095,958,1137,6.444,14.093,209,1.406,28.186,65,65,279
2018,21980,418,439,6659,5924,33,7.475,38,8.607,1960,256,1704,4.322,33.089,558,208,350,3.511,9.42,1402,23.668,18.84,28,28,85
2018,22020,5277,6258,125427,124328,435,6.924,484,7.704,15617,5274,10343,4.242,12.561,13533,3766,9767,3.029,10.885,2084,1.676,21.77,369,382,2291
2018,22060,1212,1349,24654,24484,75,5.495,107,7.839,1863,381,1482,1.556,7.609,1505,490,1015,2.001,6.147,358,1.462,12.294,78,79,237
2018,22100,1154,1317,19466,19172,118,8.99,109,8.305,2318,919,1399,4.794,12.091,1684,568,1116,2.963,8.784,634,3.307,17.568,87,87,418
2018,22140,2050,2384,35640,35251,171,7.129,200,8.339,4119,1144,2975,3.245,11.685,3385,1070,2315,3.035,9.603,734,2.082,19.205,140,144,725
2018,22180,4486,5696,99312,98932,490,8.622,464,8.165,11570,3946,7624,3.989,11.695,10804,3355,7449,3.391,10.921,766,0.774,21.841,331,340,2340
2018,22220,8692,11456,224058,220469,1048,9.255,782,6.906,27809,7447,20362,3.378,12.614,20836,4381,16455,1.987,9.451,6973,3.163,18.902,579,587,2743
2018,22260,1319,1480,18865,19032,86,5.78,102,6.855,1573,331,1242,1.739,8.265,1902,343,1559,1.802,9.994,-329,-1.729,16.53,86,87,302
2018,22280,681,735,10436,10462,63,8.531,70,9.479,1179,338,841,3.231,11.269,1233,565,668,5.4,11.786,-54,-0.516,22.539,55,55,376
2018,22300,1373,1615,44294,43677,88,5.442,92,5.69,4901,982,3919,2.248,11.221,3557,600,2957,1.374,8.144,1344,3.077,16.288,59,61,370
2018,22340,276,286,4657,4592,18,6.218,25,8.636,448,171,277,3.724,9.756,310,109,201,2.374,6.751,138,3.005,13.502,20,20,71
2018,22380,2946,3343,54896,54088,306,9.21,265,7.976,6810,1899,4911,3.511,12.591,5099,1803,3296,3.333,9.427,1711,3.163,18.854,198,202,1371
2018,22420,5712,7058,127281,127819,467,6.596,512,7.231,12621,3173,9448,2.482,9.874,13635,3481,10154,2.723,10.667,-1014,-0.793,19.748,384,389,2235
2018,22500,3252,3951,74287,75130,269,6.797,282,7.126,8559,2464,6095,3.28,11.392,10051,5156,4895,6.863,13.378,-1492,-1.986,22.785,180,181,2177
2018,22520,2484,2974,59847,59039,193,6.463,217,7.267,6303,1275,5028,2.16,10.676,4722,1123,3599,1.902,7.998,1581,2.678,15.996,162,163,835
2018,22540,1826,2124,44152,43855,123,5.779,132,6.202,3726,758,2968,1.728,8.496,3155,1076,2079,2.454,7.194,571,1.302,14.388,88,88,482
2018,22580,1085,1178,16096,15933,98,8.394,77,6.595,2147,541,1606,3.396,13.476,1840,435,1405,2.73,11.549,307,1.927,23.097,59,59,248
2018,22620,380,420,5559,5523,26,6.183,27,6.421,678,118,560,2.137,12.276,606,79,527,1.43,10.972,72,1.304,21.945,21,21,63
2018,22660,8651,9752,127969,127184,1025,10.625,815,8.448,16497,5521,10976,4.341,12.971,14976,4766,10210,3.747,11.775,1521,1.196,23.55,626,643,3087
2018,22700,835,920,16391,16303,77,8.415,67,7.322,1830,327,1503,2.006,11.225,1672,351,1321,2.153,10.256,158,0.969,20.512,52,53,255
2018,22780,565,640,8512,8570,50,7.74,62,9.598,884,132,752,1.54,10.315,999,240,759,2.8,11.657,-115,-1.342,20.63,40,40,161
2018,22800,1112,1269,18436,18346,87,6.816,102,7.991,1737,421,1316,2.295,9.468,1529,376,1153,2.049,8.334,208,1.134,16.668,82,84,276
2018,22820,597,642,9946,9722,50,7.806,47,7.338,1259,335,924,3.446,12.95,804,296,508,3.045,8.27,455,4.68,16.54,37,37,225
2018,22860,575,638,7491,7546,61,9.524,66,10.304,911,368,543,4.877,12.073,1052,328,724,4.347,13.941,-141,-1.869,24.145,42,44,251
2018,22900,4461,5430,97737,97530,459,8.488,414,7.656,11086,3331,7755,3.415,11.367,10563,2767,7796,2.837,10.831,523,0.536,21.661,302,302,1513
2018,23060,7822,9715,203842,202994,670,6.916,614,6.338,19588,4572,15016,2.252,9.65,17833,4693,13140,2.312,8.785,1755,0.865,17.57,453,462,2467
2018,23140,501,564,10053,10135,48,8.541,44,7.829,789,184,605,1.815,7.785,939,231,708,2.279,9.265,-150,-1.48,15.57,31,31,131
2018,23180,1237,1429,20578,20465,102,7.176,87,6.12,1885,447,1438,2.184,9.211,1717,626,1091,3.059,8.39,168,0.821,16.78,61,62,445
2018,23240,926,957,9703,9669,99,10.487,73,7.733,1114,347,767,3.589,11.522,1030,340,690,3.517,10.653,84,0.869,21.306,57,57,227
2018,23300,859,966,14670,14720,59,6.13,52,5.403,1324,227,1097,1.542,8.995,1396,338,1058,2.296,9.484,-72,-0.489,17.989,43,44,285
2018,23340,857,918,16310,16296,52,5.609,70,7.551,1309,358,951,2.197,8.033,1254,310,944,1.902,7.695,55,0.338,15.391,56,58,223
2018,23380,1026,1238,23358,23305,71,5.728,74,5.97,1977,351,1626,1.506,8.483,1864,465,1399,1.995,7.998,113,0.485,15.997,48,49,238
2018,23420,12856,15549,276512,273590,1470,9.518,1262,8.171,37143,11908,25235,4.353,13.576,31011,7284,23727,2.662,11.335,6132,2.241,22.67,935,946,4781
2018,23460,1602,1837,30302,30413,108,5.836,135,7.295,2948,862,2086,2.834,9.693,3241,959,2282,3.153,10.657,-293,-0.963,19.386,103,104,527
2018,23500,806,879,18754,18630,51,5.782,57,6.463,1781,339,1442,1.82,9.56,1525,363,1162,1.948,8.186,256,1.374,16.371,37,38,101
2018,23540,5053,5849,100206,98288,544,9.325,513,8.794,13317,3904,9413,3.972,13.549,9484,3323,6161,3.381,9.649,3833,3.9,19.298,378,385,2263
2018,23580,3592,4003,83246,81059,368,9.277,296,7.462,12679,3641,9038,4.492,15.642,8210,3309,4901,4.082,10.128,4469,5.513,20.257,222,222,1055
2018,23620,803,847,13348,12987,58,6.868,53,6.276,1910,331,1579,2.549,14.708,1177,342,835,2.634,9.063,733,5.644,18.127,41,41,245
2018,23660,824,934,15486,15590,56,5.973,63,6.72,1397,460,937,2.951,8.961,1577,372,1205,2.386,10.115,-180,-1.155,17.922,41,42,236
2018,23700,773,923,16369,16447,43,4.601,66,7.063,1651,504,1147,3.064,10.039,1776,612,1164,3.721,10.799,-125,-0.76,20.077,47,48,270
2018,23780,919,1012,15764,15888,65,6.394,74,7.28,1130,369,761,2.323,7.113,1362,229,1133,1.441,8.573,-232,-1.46,14.225,56,56,150
2018,23820,1324,1420,18470,18043,157,11.222,115,8.22,2524,635,1889,3.519,13.989,1663,362,1301,2.006,9.217,861,4.772,18.434,91,92,270
2018,23860,1485,1654,20219,19760,130,7.864,128,7.743,2641,684,1957,3.462,13.366,1682,606,1076,3.067,8.512,959,4.853,17.025,100,102,391
2018,23900,1595,1805,29704,29423,102,5.645,106,5.866,3218,806,2412,2.739,10.937,2633,517,2116,1.757,8.949,585,1.988,17.898,80,80,282
2018,23940,1238,1324,20001,19890,100,7.493,121,9.067,2124,381,1743,1.916,10.679,1861,480,1381,2.413,9.357,263,1.322,18.713,94,94,337
2018,23980,773,873,15668,15973,44,4.911,90,10.045,1273,248,1025,1.553,7.97,1847,929,918,5.816,11.563,-574,-3.594,15.939,73,73,414
2018,24020,2445,2880,43227,43377,190,6.58,205,7.1,4147,1091,3056,2.515,9.56,4417,991,3426,2.285,10.183,-270,-0.622,19.121,152,155,681
2018,24060,3134,3429,37630,37492,335,9.895,248,7.325,4502,1181,3321,3.15,12.008,4265,1464,2801,3.905,11.376,237,0.632,22.752,191,191,748
2018,24100,885,1041,14265,14356,53,5.043,73,6.946,1254,333,921,2.32,8.735,1454,473,981,3.295,10.128,-200,-1.393,17.47,53,53,242
2018,24140,1735,2002,33552,33671,132,6.562,151,7.507,3061,645,2416,1.916,9.091,3339,1337,2002,3.971,9.917,-278,-0.826,18.182,104,105,958
2018,24220,2075,2411,42880,42937,139,5.752,150,6.207,3701,903,2798,2.103,8.62,3798,1173,2625,2.732,8.846,-97,-0.226,17.239,109,112,613
2018,24260,2078,2419,37195,36825,160,6.616,159,6.574,4358,1545,2813,4.196,11.834,3682,1032,2650,2.802,9.999,676,1.836,19.997,128,134,726
2018,24300,3589,3960,81792,81121,378,9.583,347,8.797,7077,1785,5292,2.2,8.724,5688,2324,3364,2.865,7.012,1389,1.712,14.024,268,275,1607
2018,24340,18308,22834,534117,529794,1777,7.842,1428,6.302,55757,14355,41402,2.71,10.524,46684,11294,35390,2.132,8.812,9073,1.713,17.623,1024,1048,7271
2018,24380,243,279,5311,5351,11,3.853,24,8.406,347,59,288,1.103,6.485,437,137,300,2.56,8.167,-90,-1.682,12.97,19,19,117
2018,24420,1664,1871,23975,23501,183,9.938,124,6.734,3035,926,2109,3.94,12.914,2070,419,1651,1.783,8.808,965,4.106,17.616,101,101,322
2018,24460,786,863,9971,10125,40,4.571,64,7.314,926,323,603,3.19,9.146,1268,311,957,3.072,12.523,-342,-3.378,18.291,46,48,229
2018,24500,1961,2205,30407,30383,156,7.043,176,7.946,3281,1110,2171,3.653,10.799,3223,1244,1979,4.094,10.608,58,0.191,21.216,124,124,536
2018,24540,5069,5677,89223,87175,661,11.818,493,8.815,12017,3155,8862,3.619,13.785,7902,2541,5361,2.915,9.065,4115,4.72,18.129,400,403,2026
2018,24580,5935,7238,160800,159382,519,7.187,485,6.717,18112,7119,10993,4.467,11.364,15271,3991,11280,2.504,9.581,2841,1.783,19.163,338,346,1734
2018,24620,922,1057,24822,24555,71,6.714,72,6.809,2444,409,2035,1.666,9.953,2020,400,1620,1.629,8.227,424,1.727,16.453,43,48,254
2018,24640,1288,1424,20387,20278,98,6.906,88,6.202,2055,658,1397,3.245,10.134,1908,485,1423,2.392,9.409,147,0.725,18.819,69,69,309
2018,24660,13237,16290,332948,331808,1354,8.34,1243,7.657,39390,11401,27989,3.436,11.871,36936,11147,25789,3.359,11.132,2454,0.74,22.263,870,897,5715
2018,24700,561,596,12154,12868,36,6.081,28,4.73,823,100,723,0.777,6.396,2185,105,2080,0.816,16.981,-1362,-10.585,12.792,20,20,49
2018,24740,908,1045,13402,13614,61,5.818,68,6.485,1175,422,753,3.1,8.631,1579,492,1087,3.614,11.598,-404,-2.968,17.262,54,54,301
2018,24780,2852,3332,62252,61504,261,7.882,220,6.644,7200,1984,5216,3.226,11.707,5622,1852,3770,3.011,9.141,1578,2.566,18.282,159,160,1242
2018,24820,972,1048,16571,16450,67,6.405,63,6.023,2166,597,1569,3.629,13.167,1927,705,1222,4.286,11.714,239,1.453,23.429,46,46,528
2018,24860,14847,18442,364766,359704,1698,9.28,1408,7.695,52180,16713,35467,4.646,14.506,41722,9835,31887,2.734,11.599,10458,2.907,23.198,1019,1042,5765
2018,24900,663,748,12862,12738,49,6.525,55,7.324,1317,353,964,2.771,10.339,1043,222,821,1.743,8.188,274,2.151,16.376,38,38,155
2018,24940,1375,1564,27475,26966,100,6.412,91,5.835,3101,770,2331,2.855,11.5,2136,699,1437,2.592,7.921,965,3.579,15.842,66,66,254
2018,24980,479,518,9425,8880,28,5.405,28,5.405,1426,681,745,7.669,16.059,399,69,330,0.777,4.493,1027,11.566,8.987,23,23,58
2018,25060,5287,6723,129105,129614,508,7.569,485,7.226,12072,3399,8673,2.622,9.314,13195,3356,9839,2.589,10.18,-1123,-0.866,18.628,326,339,1767
2018,25100,400,430,7848,7814,29,6.674,38,8.746,848,168,680,2.15,10.853,807,495,312,6.335,10.328,41,0.525,20.657,25,25,316
2018,25180,3867,4736,87675,86695,349,7.377,339,7.166,10349,2730,7619,3.149,11.937,8378,3306,5072,3.813,9.664,1971,2.273,19.328,241,244,1743
2018,25200,1315,1399,12435,12332,155,11.277,106,7.712,1658,509,1149,4.127,13.445,1451,328,1123,2.66,11.766,207,1.679,23.532,86,86,259
2018,25220,1972,2261,36569,36304,183,8.126,165,7.327,5213,1661,3552,4.575,14.359,4731,1183,3548,3.259,13.032,482,1.328,26.064,129,131,739
2018,25260,1339,1498,26241,25648,132,8.844,121,8.107,3067,714,2353,2.784,11.958,1896,517,1379,2.016,7.393,1171,4.566,14.785,92,94,406
2018,25300,819,930,14355,14543,72,7.713,79,8.463,1223,336,887,2.31,8.41,1599,588,1011,4.043,10.995,-376,-2.586,16.82,60,60,412
2018,25420,9943,12860,281971,280279,866,6.732,872,6.779,27411,7197,20214,2.568,9.78,24042,8083,15959,2.884,8.578,3369,1.202,17.156,559,566,2948
2018,25460,780,877,13087,13164,69,7.762,93,10.461,1330,324,1006,2.461,10.104,1453,497,956,3.776,11.038,-123,-0.934,20.207,68,68,315
2018,25500,2548,2901,53854,52889,208,7.212,174,6.033,6255,1987,4268,3.757,11.827,4418,1087,3331,2.055,8.353,1837,3.473,16.707,124,124,702
2018,25540,21042,26888,553134,552470,1990,7.372,2205,8.168,64229,21733,42496,3.934,11.626,63452,18662,44790,3.378,11.485,777,0.141,22.97,1400,1448,10206
2018,25580,837,910,13516,13586,51,5.601,52,5.711,1216,347,869,2.554,8.951,1333,415,918,3.055,9.812,-117,-0.861,17.901,34,35,245
2018,25620,2615,3152,51984,51612,259,8.259,227,7.239,6239,1712,4527,3.317,12.088,5481,1276,4205,2.472,10.62,758,1.469,21.239,162,168,817
2018,25700,974,1032,12495,12468,69,6.689,68,6.592,1275,356,919,2.855,10.226,1230,270,960,2.166,9.865,45,0.361,19.731,51,52,154
2018,25720,781,792,6652,6473,116,14.853,94,12.036,1287,499,788,7.71,19.884,937,508,429,7.849,14.477,350,5.407,28.953,61,61,313
2018,25740,2177,2354,27464,27290,220,9.452,167,7.175,2771,933,1838,3.419,10.154,2405,708,1697,2.594,8.813,366,1.341,17.626,119,120,494
2018,25760,317,357,3886,3966,37,10.437,32,9.027,457,177,280,4.463,11.523,580,106,474,2.673,14.624,-123,-3.101,23.046,21,21,33
2018,25780,705,794,13187,13486,56,7.026,62,7.779,1253,462,791,3.426,9.291,1926,488,1438,3.619,14.282,-673,-4.991,18.583,46,46,377
2018,25820,343,360,5421,5423,20,5.427,37,10.041,490,90,400,1.66,9.036,488,212,276,3.909,8.999,2,0.037,17.997,33,33,153
2018,25840,1389,1605,27257,27110,121,7.546,118,7.359,2602,426,2176,1.571,9.598,2300,628,1672,2.317,8.484,302,1.114,16.968,84,85,355
2018,25860,5825,7045,138534,136733,546,7.786,481,6.859,16095,5484,10611,4.011,11.771,12478,3583,8895,2.62,9.126,3617,2.645,18.252,338,351,2272
2018,25880,628,687,10755,10748,41,5.981,38,5.543,900,216,684,2.01,8.374,905,239,666,2.224,8.42,-5,-0.047,16.747,28,28,161
2018,25900,3193,3836,60502,60259,342,8.985,283,7.435,7364,2981,4383,4.947,12.221,6765,1900,4865,3.153,11.227,599,0.994,22.453,221,225,1467
2018,25940,4720,5379,64674,63955,513,9.609,432,8.092,8226,2539,5687,3.97,12.862,6882,2251,4631,3.52,10.761,1344,2.101,21.521,315,322,1254
2018,25980,754,852,13145,12739,73,8.553,76,8.905,1864,663,1201,5.204,14.632,1112,289,823,2.269,8.729,752,5.903,17.458,53,56,203
2018,26020,1368,1576,24874,24217,147,9.399,123,7.864,3987,968,3019,3.997,16.464,2634,529,2105,2.184,10.877,1353,5.587,21.753,89,89,374
2018,26090,1962,2168,38740,38397,169,7.846,141,6.546,4384,1251,3133,3.258,11.418,3762,1227,2535,3.196,9.798,622,1.62,19.595,104,105,968
2018,26140,2228,2545,30906,31016,256,10.129,221,8.744,3765,1662,2103,5.359,12.139,3971,1849,2122,5.961,12.803,-206,-0.664,24.278,174,176,869
2018,26220,846,904,10790,10834,69,7.624,71,7.845,1146,249,897,2.298,10.578,1261,282,979,2.603,11.639,-115,-1.061,21.156,54,54,191
2018,26300,2189,2471,34823,34660,197,7.942,216,8.708,4761,1960,2801,5.655,13.736,4313,1919,2394,5.537,12.444,448,1.293,24.887,153,153,1084
2018,26340,754,829,9253,9354,64,7.762,55,6.671,983,319,664,3.41,10.509,1212,356,856,3.806,12.957,-229,-2.448,21.018,39,39,263
2018,26380,3528,4180,74637,74326,243,5.746,341,8.063,9012,2013,6999,2.708,12.125,8378,2902,5476,3.904,11.272,634,0.853,22.544,237,239,1710
2018,26420,100098,130122,2755378,2734033,13629,10.542,11944,9.239,370444,112262,258182,4.106,13.549,327572,98690,228882,3.61,11.981,42872,1.568,23.963,8826,9089,60301
2018,26460,1472,1583,16786,16670,124,7.786,143,8.98,2013,421,1592,2.525,12.076,1792,492,1300,2.951,10.75,221,1.326,21.5,107,107,311
2018,26500,658,752,9772,9831,46,6.117,46,6.117,764,166,598,1.689,7.772,900,299,601,3.042,9.155,-136,-1.383,15.543,37,37,167
2018,26540,728,808,13124,13149,57,7.028,63,7.768,1175,236,939,1.795,8.936,1221,245,976,1.863,9.286,-46,-0.35,17.873,48,48,157
2018,26580,4790,6339,110513,110682,376,5.918,405,6.374,11734,3669,8065,3.315,10.602,12068,3514,8554,3.175,10.903,-334,-0.302,21.203,292,294,2045
2018,26620,7378,9141,190160,188368,720,7.89,688,7.54,22837,5906,16931,3.135,12.124,19012,5102,13910,2.709,10.093,3825,2.031,20.186,486,499,2510
2018,26660,1027,1100,14318,14115,107,9.785,94,8.596,1921,669,1252,4.74,13.61,1479,606,873,4.293,10.478,442,3.131,20.956,74,74,339
2018,26700,458,506,7020,7003,19,3.679,40,7.744,546,46,500,0.657,7.797,503,140,363,1.999,7.183,43,0.614,14.365,32,32,117
2018,26740,1327,1468,22483,22429,92,6.237,106,7.186,2193,553,1640,2.466,9.778,2066,546,1520,2.434,9.211,127,0.566,18.423,73,73,366
2018,26780,765,859,15526,15561,48,5.549,60,6.936,1441,306,1135,1.966,9.26,1472,470,1002,3.02,9.46,-31,-0.199,18.521,40,41,346
2018,26820,3335,3695,58356,57274,352,9.654,254,6.967,6979,1639,5340,2.862,12.185,4844,1291,3553,2.254,8.458,2135,3.728,16.915,194,196,973
2018,26860,1462,1687,24556,24614,106,6.265,116,6.856,2050,441,1609,1.792,8.329,2136,451,1685,1.832,8.678,-86,-0.349,16.658,80,81,244
2018,26900,32112,43206,971149,964226,3758,8.716,3574,8.29,126197,34347,91850,3.562,13.088,112197,39282,72915,4.074,11.636,14000,1.452,23.272,2398,2564,22727
2018,26940,347,394,5378,5404,24,6.03,32,8.04,475,162,313,2.998,8.79,531,169,362,3.127,9.826,-56,-1.036,17.58,21,21,116
2018,26960,742,799,11327,11260,64,8.086,49,6.191,1190,323,867,2.869,10.568,1033,344,689,3.055,9.174,157,1.394,18.348,35,35,115
2018,26980,3198,3662,72887,71906,292,8.036,235,6.468,7226,1875,5351,2.608,10.049,5273,1236,4037,1.719,7.333,1953,2.716,14.666,173,179,793
2018,27020,781,836,13012,13029,46,5.457,60,7.117,1175,139,1036,1.067,9.018,1201,463,738,3.554,9.218,-26,-0.2,18.037,48,48,354
2018,27060,1954,2169,49165,48651,166,7.703,138,6.404,3932,766,3166,1.574,8.082,3024,635,2389,1.305,6.216,908,1.866,12.432,109,109,352
2018,27100,2290,2702,52275,51128,193,7.184,162,6.03,5816,2757,3059,5.392,11.375,3583,818,2765,1.6,7.008,2233,4.368,14.016,117,120,570
2018,27140,9707,12190,227201,227847,938,7.699,925,7.592,21768,6486,15282,2.847,9.554,23089,6559,16530,2.879,10.134,-1321,-0.58,19.108,639,658,4001
2018,27160,493,578,8478,8717,34,5.872,36,6.218,731,147,584,1.686,8.386,1230,290,940,3.327,14.111,-499,-5.725,16.773,25,26,124
2018,27180,2407,2815,59839,59990,193,6.872,180,6.409,5452,1924,3528,3.207,9.088,5862,1461,4401,2.435,9.772,-410,-0.683,18.177,125,131,728
2018,27220,2055,2136,20908,20786,246,11.659,194,9.194,2858,1179,1679,5.672,13.75,2630,1029,1601,4.951,12.653,228,1.097,25.306,146,155,832
2018,27260,27126,34439,614112,607121,3731,10.901,3307,9.662,83425,25613,57812,4.219,13.741,69571,21352,48219,3.517,11.459,13854,2.282,22.918,2416,2496,11978
2018,27300,750,845,13216,13536,46,5.409,57,6.702,1075,165,910,1.219,7.942,1708,561,1147,4.145,12.618,-633,-4.676,15.884,41,41,285
2018,27340,2128,2599,36688,36094,211,8.133,202,7.786,4627,1813,2814,5.023,12.819,3431,815,2616,2.258,9.506,1196,3.314,19.012,137,137,563
2018,27380,634,694,10583,10870,63,9.124,56,8.11,827,188,639,1.73,7.608,1352,615,737,5.658,12.438,-525,-4.83,15.216,45,45,433
2018,27420,561,603,9096,9121,43,7.143,41,6.811,668,218,450,2.39,7.324,739,218,521,2.39,8.103,-71,-0.778,14.648,30,30,160
2018,27460,2211,2557,40844,40655,161,6.267,185,7.201,4792,731,4061,1.798,11.787,4506,1146,3360,2.819,11.084,286,0.703,22.167,132,136,732
2018,27500,2595,3084,61626,60558,187,6.043,208,6.722,6710,1239,5471,2.046,11.08,4630,1086,3544,1.793,7.646,2080,3.435,15.291,151,151,739
2018,27540,1210,1377,31057,31038,78,5.652,84,6.087,2613,401,2212,1.292,8.419,2591,578,2013,1.862,8.348,22,0.071,16.696,62,62,189
2018,27600,1113,1203,28174,26919,134,11.342,91,7.702,4821,1936,2885,7.192,17.91,2354,865,1489,3.213,8.745,2467,9.165,17.49,65,65,326
2018,27620,2802,3293,53623,53808,242,7.357,235,7.144,5557,1189,4368,2.21,10.328,5893,2083,3810,3.871,10.952,-336,-0.624,20.655,183,186,804
2018,27700,501,528,5899,5887,32,6.032,37,6.975,613,182,431,3.092,10.414,564,157,407,2.667,9.581,49,0.832,19.162,28,28,112
2018,27740,2946,3582,65011,65298,240,6.696,244,6.808,6088,1597,4491,2.446,9.323,6705,1637,5068,2.507,10.268,-617,-0.945,18.647,168,174,890
2018,27780,2361,2916,45887,46165,138,4.703,174,5.93,4060,1285,2775,2.783,8.795,4633,1000,3633,2.166,10.036,-573,-1.241,17.589,119,120,544
2018,27860,2259,2687,47887,47829,203,7.583,183,6.836,5031,1295,3736,2.708,10.519,4965,1182,3783,2.471,10.381,66,0.138,20.762,135,136,927
2018,27900,3097,3727,76570,75477,301,8.079,298,7.999,9596,4051,5545,5.367,12.714,7226,1858,5368,2.462,9.574,2370,3.14,19.148,221,222,1110
2018,27920,442,527,7642,7796,24,4.537,28,5.293,585,65,520,0.834,7.504,871,208,663,2.668,11.173,-286,-3.669,15.009,15,15,84
2018,27940,880,993,10893,10981,88,8.889,82,8.283,1361,462,899,4.207,12.394,1548,303,1245,2.759,14.097,-187,-1.703,24.788,58,58,176
2018,27980,3652,4342,68834,67769,365,8.46,310,7.185,7720,2487,5233,3.67,11.392,5488,1376,4112,2.03,8.098,2232,3.294,16.196,238,243,1068
2018,28020,5280,6361,129087,128608,476,7.495,455,7.165,12092,2763,9329,2.148,9.402,11080,3978,7102,3.093,8.615,1012,0.787,17.231,339,346,1590
2018,28060,3243,3520,39456,38843,382,10.961,312,8.953,4934,1500,3434,3.862,12.702,3705,1347,2358,3.468,9.538,1229,3.164,19.077,257,257,946
2018,28100,1833,2114,39770,38994,138,6.491,162,7.62,5875,1501,4374,3.849,15.067,4436,1668,2768,4.278,11.376,1439,3.69,22.753,121,123,1073
2018,28140,37045,47834,991014,984179,4371,9.158,4164,8.724,124856,33053,91803,3.358,12.686,110635,33431,77204,3.397,11.241,14221,1.445,22.483,2888,2967,16878
2018,28180,1706,1974,28534,28526,164,8.365,137,6.988,2758,849,1909,2.976,9.668,2688,839,1849,2.941,9.423,70,0.245,18.846,98,99,375
2018,28260,1551,1722,24306,24523,122,7.103,113,6.579,2493,733,1760,2.989,10.166,2961,929,2032,3.788,12.075,-468,-1.908,20.332,79,84,433
2018,28300,1592,1758,27654,27238,126,7.169,125,7.112,3079,978,2101,3.591,11.304,2224,729,1495,2.676,8.165,855,3.139,16.33,95,96,469
2018,28340,734,816,16795,16340,51,6.269,46,5.655,2146,1226,920,7.503,13.133,1335,152,1183,0.93,8.17,811,4.963,16.34,33,33,119
2018,28380,545,612,6899,6909,56,9.15,56,9.15,662,103,559,1.491,9.582,662,274,388,3.966,9.582,0,0,19.165,42,43,124
2018,28420,4760,5544,93442,90505,571,10.436,426,7.786,13647,5609,8038,6.197,15.079,7920,2176,5744,2.404,8.751,5727,6.328,17.502,330,336,1549
2018,28500,1213,1318,16408,16516,111,8.425,110,8.349,1633,559,1074,3.385,9.888,1815,480,1335,2.906,10.99,-182,-1.102,19.775,96,96,403
2018,28540,445,479,4904,4845,36,7.446,45,9.307,538,89,449,1.837,11.105,422,119,303,2.456,8.711,116,2.394,17.422,32,32,94
2018,28580,3075,3372,31051,31637,334,9.857,367,10.831,4220,1719,2501,5.434,13.339,5409,1920,3489,6.069,17.097,-1189,-3.758,26.678,276,287,1375
2018,28620,1492,1723,16088,15885,172,10.115,127,7.468,2323,772,1551,4.86,14.624,1889,450,1439,2.833,11.892,434,2.732,23.784,91,91,283
2018,28660,4625,5860,110273,107899,578,9.887,550,9.408,18208,8296,9912,7.689,16.875,13427,3367,10060,3.121,12.444,4781,4.431,24.888,403,418,2297
2018,28700,4312,5567,105015,104592,361,6.471,384,6.884,11531,2559,8972,2.447,11.025,10616,4258,6358,4.071,10.15,915,0.875,20.3,263,277,1773
2018,28740,3914,4327,46717,46473,376,8.744,322,7.488,5873,2206,3667,4.747,12.638,5388,1778,3610,3.826,11.594,485,1.044,23.188,246,247,1094
2018,28780,491,536,7044,6797,39,7.229,46,8.526,1094,463,631,6.812,16.095,614,245,369,3.605,9.033,480,7.062,18.067,36,37,216
2018,28820,977,1111,23603,23848,73,6.553,79,7.092,1551,366,1185,1.535,6.504,2051,620,1431,2.6,8.6,-500,-2.097,13.007,60,60,490
2018,28860,585,635,8879,8326,42,6.609,43,6.766,1897,290,1607,3.483,22.784,742,267,475,3.207,8.912,1155,13.872,17.824,36,36,241
2018,28900,1262,1387,18015,17670,127,9.28,90,6.577,2095,512,1583,2.898,11.856,1423,365,1058,2.066,8.053,672,3.803,16.106,71,71,225
2018,28940,12837,17026,350372,352525,1228,7.208,1247,7.32,38223,11137,27086,3.159,10.843,42476,10006,32470,2.838,12.049,-4253,-1.206,21.685,879,900,4242
2018,29020,1425,1668,31704,31893,102,6.115,102,6.115,3009,696,2313,2.182,9.435,3475,1586,1889,4.973,10.896,-466,-1.461,18.87,71,75,1269
2018,29060,1462,1616,21549,21550,134,8.328,120,7.458,2110,788,1322,3.657,9.791,2095,630,1465,2.923,9.722,15,0.07,19.443,92,92,367
2018,29100,2689,3243,69115,68697,182,5.606,189,5.822,7505,2716,4789,3.954,10.925,6622,1574,5048,2.291,9.64,883,1.285,19.279,134,135,731
2018,29180,10024,11985,184685,184339,1012,8.457,975,8.148,21951,5649,16302,3.064,11.908,21317,5616,15701,3.047,11.564,634,0.344,23.128,697,734,3766
2018,29200,3199,3927,78086,77446,292,7.454,273,6.969,9676,3446,6230,4.45,12.494,8288,2247,6041,2.901,10.702,1388,1.792,21.403,191,200,1551
2018,29260,633,676,7464,7418,69,10.407,43,6.486,835,272,563,3.667,11.256,746,185,561,2.494,10.057,89,1.2,20.113,35,35,95
2018,29300,1185,1352,34643,35435,117,8.702,102,7.586,3338,1136,2202,3.206,9.42,4837,959,3878,2.706,13.65,-1499,-4.23,18.84,80,82,884
2018,29340,3719,4495,80575,79778,333,7.413,327,7.28,9879,3305,6574,4.143,12.383,8310,2422,5888,3.036,10.416,1569,1.967,20.833,252,260,1625
2018,29380,1129,1274,19003,18702,121,9.626,87,6.921,2172,824,1348,4.406,11.614,1595,399,1196,2.133,8.528,577,3.085,17.057,67,68,238
2018,29420,2972,3494,43110,42562,271,7.772,257,7.37,5660,1631,4029,3.832,13.298,4479,1454,3025,3.416,10.524,1181,2.775,21.047,192,199,880
2018,29460,8900,10770,200886,196093,1107,10.389,878,8.24,27094,7054,20040,3.597,13.817,17629,5543,12086,2.827,8.99,9465,4.827,17.98,669,672,3003
2018,29500,245,254,2591,2580,23,9.218,14,5.611,392,194,198,7.519,15.194,372,130,242,5.039,14.419,20,0.775,28.837,11,11,84
2018,29540,10337,12294,240580,238494,911,7.461,743,6.085,26043,6969,19074,2.922,10.92,21732,6769,14963,2.838,9.112,4311,1.808,18.224,550,553,3373
2018,29620,7248,8781,170962,170700,682,7.795,618,7.064,17458,4589,12869,2.688,10.227,16935,4256,12679,2.493,9.921,523,0.306,19.842,450,459,2771
2018,29660,911,943,9755,9667,73,7.721,78,8.25,1643,987,656,10.21,16.996,1558,909,649,9.403,16.117,85,0.879,32.233,62,62,797
2018,29700,4386,5142,80578,80010,497,9.729,430,8.417,9741,3032,6709,3.79,12.175,8520,2698,5822,3.372,10.649,1221,1.526,21.297,328,347,2045
2018,29740,2932,3411,52974,52992,290,8.497,294,8.614,5970,1912,4058,3.608,11.266,6016,2357,3659,4.448,11.353,-46,-0.087,22.532,215,215,1085
2018,29780,371,414,6431,6555,34,8.232,32,7.748,391,122,269,1.861,5.965,643,194,449,2.96,9.81,-252,-3.845,11.931,22,22,89
2018,29820,32021,41115,900312,890619,5178,12.753,4155,10.233,118090,43351,74739,4.868,13.259,98791,31988,66803,3.592,11.092,19299,2.167,22.185,3049,3131,18643
2018,29860,1291,1463,25435,25505,91,6.239,82,5.622,2195,426,1769,1.67,8.606,2332,544,1788,2.133,9.143,-137,-0.537,17.212,60,60,365
2018,29900,482,554,9571,9567,28,5.031,33,5.93,964,184,780,1.923,10.077,951,157,794,1.641,9.941,13,0.136,19.882,28,28,108
2018,29940,2320,2497,40892,40624,195,7.825,185,7.424,3863,978,2885,2.407,9.509,3354,1023,2331,2.518,8.256,509,1.253,16.512,142,142,668
2018,29980,622,682,8382,8469,47,6.902,45,6.608,835,309,526,3.649,9.86,1013,330,683,3.897,11.962,-178,-2.102,19.72,35,36,230
2018,30020,1744,2045,32879,32768,142,6.898,169,8.21,3543,1259,2284,3.842,10.812,3349,1647,1702,5.026,10.22,194,0.592,20.441,114,114,613
2018,30060,637,692,11476,11429,52,7.407,72,10.256,1012,166,846,1.453,8.855,928,265,663,2.319,8.12,84,0.735,16.24,57,57,183
2018,30140,2188,2509,48046,47384,149,5.936,151,6.016,5004,1060,3944,2.237,10.561,3628,847,2781,1.788,7.657,1376,2.904,15.313,113,113,506
2018,30220,420,464,6997,6785,36,7.767,35,7.551,1000,213,787,3.14,14.739,570,146,424,2.152,8.402,430,6.338,16.803,25,25,118
2018,30260,782,881,16498,16316,68,7.803,49,5.622,1291,306,985,1.875,7.912,913,294,619,1.802,5.596,378,2.317,11.191,30,32,193
2018,30280,419,462,8378,8276,29,6.277,29,6.277,841,194,647,2.344,10.163,639,178,461,2.151,7.722,202,2.441,15.443,21,21,95
2018,30300,1273,1449,23300,23400,93,6.398,102,7.018,2103,565,1538,2.415,8.987,2307,502,1805,2.145,9.859,-204,-0.872,17.974,73,74,331
2018,30340,2176,2529,46271,46136,184,7.266,191,7.542,4494,1980,2514,4.292,9.741,4250,1519,2731,3.292,9.212,244,0.529,18.424,142,146,1009
2018,30380,803,915,14962,14750,56,6.137,51,5.589,1579,347,1232,2.353,10.705,1153,252,901,1.708,7.817,426,2.888,15.634,36,36,126
2018,30420,603,683,9071,9221,37,5.394,43,6.268,733,171,562,1.855,7.95,1015,414,601,4.49,11.008,-282,-3.058,15.899,29,29,198
2018,30460,9337,11471,232079,231334,878,7.656,873,7.612,24665,7552,17113,3.265,10.662,23550,8654,14896,3.741,10.18,1115,0.482,20.36,635,654,5895
2018,30580,472,515,8838,8708,28,5.379,39,7.493,851,152,699,1.746,9.773,572,138,434,1.585,6.569,279,3.204,13.138,30,30,103
2018,30620,1920,2231,45838,46460,118,5.275,130,5.811,3827,909,2918,1.957,8.237,5139,1104,4035,2.376,11.061,-1312,-2.824,16.474,81,88,814
2018,30660,469,526,7483,7444,32,6.113,27,5.158,671,243,428,3.264,9.014,590,184,406,2.472,7.926,81,1.088,15.852,21,21,97
2018,30700,6961,8254,147260,145834,683,8.33,573,6.989,18058,4358,13700,2.988,12.383,15085,4091,10994,2.805,10.344,2973,2.039,20.688,421,422,1815
2018,30780,13258,16573,290561,288306,1375,8.317,1295,7.833,34435,10091,24344,3.5,11.944,29639,8071,21568,2.799,10.28,4796,1.664,20.561,934,962,5308
2018,30820,656,707,10605,10610,37,5.215,42,5.92,1095,155,940,1.461,10.321,1058,189,869,1.781,9.972,37,0.349,19.944,24,24,44
2018,30860,2916,3154,47529,46209,358,11.456,300,9.6,6939,2219,4720,4.802,15.017,4343,1765,2578,3.82,9.399,2596,5.618,18.797,235,241,1476
2018,30880,474,559,8460,8446,39,6.983,38,6.804,921,193,728,2.285,10.905,893,254,639,3.008,10.574,28,0.332,21.147,26,26,89
2018,30900,567,617,12849,12701,25,3.968,51,8.095,1193,122,1071,0.961,9.393,859,328,531,2.582,6.763,334,2.63,13.526,33,34,206
2018,30940,1758,2146,45045,44331,154,7.223,126,5.91,4695,1304,3391,2.942,10.591,3212,670,2542,1.511,7.246,1483,3.345,14.491,94,95,494
2018,30980,4182,4968,80678,79176,361,7.248,387,7.77,10862,3576,7286,4.517,13.719,7872,2526,5346,3.19,9.942,2990,3.776,19.885,299,303,1585
2018,31020,1830,2031,31902,31920,179,8.848,163,8.057,3504,1007,2497,3.155,10.977,3503,1274,2229,3.991,10.974,1,0.003,21.949,137,137,1175
2018,31060,333,348,14637,14391,26,7.493,24,6.916,1085,168,917,1.167,7.539,570,259,311,1.8,3.961,515,3.579,7.922,22,22,106
2018,31080,269644,322555,5712753,5648583,35406,11.05,31152,9.722,772684,267826,504858,4.741,13.679,642176,207802,434374,3.679,11.369,130508,2.31,22.738,23986,24524,141814
2018,31140,20518,27058,609136,602799,2126,7.867,2057,7.612,78322,22139,56183,3.673,12.993,65376,22589,42787,3.747,10.845,12946,2.148,21.691,1393,1432,10365
2018,31180,5765,6866,116925,116377,593,8.673,535,7.825,14155,4531,9624,3.893,12.163,12945,3657,9288,3.142,11.123,1210,1.04,22.247,426,427,2552
2018,31220,600,636,9084,9141,40,6.27,44,6.897,1017,372,645,4.07,11.126,1074,263,811,2.877,11.749,-57,-0.624,22.251,31,31,86
2018,31260,1548,1748,28983,28629,110,6.257,130,7.395,3159,905,2254,3.161,11.034,2500,859,1641,3,8.732,659,2.302,17.465,86,89,570
2018,31300,1386,1685,32322,31945,118,6.982,128,7.574,3679,935,2744,2.927,11.517,2968,864,2104,2.705,9.291,711,2.226,18.582,97,97,635
2018,31340,4660,5504,98612,98488,381,6.908,403,7.307,9620,2319,7301,2.355,9.768,9288,2577,6711,2.617,9.431,332,0.337,18.861,289,302,1551
2018,31380,549,610,8657,8675,30,4.866,43,6.975,871,181,690,2.086,10.04,860,279,581,3.216,9.914,11,0.127,19.827,37,37,229
2018,31420,4009,4829,88344,86338,381,7.909,358,7.431,11133,2693,8440,3.119,12.895,7207,2175,5032,2.519,8.347,3926,4.547,16.695,275,279,1340
2018,31460,1605,1770,27020,26869,163,9.24,151,8.56,2890,914,1976,3.402,10.756,2643,985,1658,3.666,9.837,247,0.919,19.673,111,114,703
2018,31500,562,620,11348,11286,44,7.137,37,6.002,1026,327,699,2.897,9.091,880,260,620,2.304,7.797,146,1.294,15.595,24,24,105
2018,31540,12818,15777,341417,338336,1171,7.432,1129,7.166,35562,8202,27360,2.424,10.511,29678,8987,20691,2.656,8.772,5884,1.739,17.544,816,844,4788
2018,31580,785,899,14192,14221,56,6.198,65,7.194,1433,260,1173,1.828,10.077,1503,375,1128,2.637,10.569,-70,-0.492,20.154,42,42,266
2018,31620,461,504,7122,7080,34,6.693,42,8.268,883,418,465,5.904,12.473,805,441,364,6.229,11.371,78,1.102,22.742,33,35,416
2018,31660,725,878,10502,10667,63,7.237,48,5.514,1089,435,654,4.078,10.209,1402,305,1097,2.859,13.143,-313,-2.934,20.418,32,33,139
2018,31680,420,466,5784,5825,39,8.423,33,7.127,708,253,455,4.343,12.155,792,362,430,6.215,13.597,-84,-1.442,24.309,27,27,338
2018,31700,8280,10116,215238,213278,813,8.055,768,7.609,27454,12012,15442,5.632,12.872,23441,6057,17384,2.84,10.991,4013,1.882,21.982,562,566,3680
2018,31740,1824,2045,30406,30449,146,7.15,140,6.856,3410,1014,2396,3.33,11.199,3488,736,2752,2.417,11.455,-78,-0.256,22.398,103,104,485
2018,31820,1448,1623,29549,29364,100,6.139,112,6.875,2903,543,2360,1.849,9.886,2538,677,1861,2.306,8.643,365,1.243,17.286,82,82,328
2018,31860,2089,2440,50773,50515,167,6.796,202,8.22,6040,1154,4886,2.284,11.957,5612,1610,4002,3.187,11.11,428,0.847,22.219,128,154,1098
2018,31900,2043,2431,42452,42720,159,6.536,162,6.66,3931,845,3086,1.978,9.202,4497,1122,3375,2.626,10.527,-566,-1.325,18.404,119,120,709
2018,31930,1109,1279,22606,22738,69,5.372,80,6.228,1886,496,1390,2.181,8.295,2135,529,1606,2.327,9.39,-249,-1.095,16.589,62,63,413
2018,31940,1227,1398,20896,20698,96,6.872,94,6.729,2178,926,1252,4.474,10.523,1757,483,1274,2.334,8.489,421,2.034,16.978,72,73,392
2018,31980,1017,1199,28720,28883,84,7.023,78,6.522,1950,428,1522,1.482,6.751,2316,394,1922,1.364,8.019,-366,-1.267,13.503,61,61,249
2018,32000,640,682,13679,13609,58,8.586,45,6.662,1321,455,866,3.343,9.707,1197,313,884,2.3,8.796,124,0.911,17.591,30,30,210
2018,32020,903,1059,22254,21983,66,6.244,62,5.866,2305,585,1720,2.661,10.485,1787,353,1434,1.606,8.129,518,2.356,16.258,47,47,215
2018,32100,1314,1494,20972,20968,106,7.069,117,7.803,2615,626,1989,2.986,12.471,2583,563,2020,2.685,12.319,32,0.153,24.638,88,88,425
2018,32140,644,752,13007,12743,69,9.28,52,6.994,1482,474,1008,3.72,11.63,921,194,727,1.522,7.228,561,4.403,14.456,39,39,136
2018,32180,404,460,7149,7039,27,5.844,31,6.71,671,152,519,2.16,9.533,454,106,348,1.506,6.45,217,3.083,12.9,24,24,57
2018,32220,1069,1176,19541,19235,83,7.001,102,8.604,2422,646,1776,3.358,12.592,1801,553,1248,2.875,9.363,621,3.228,18.726,79,79,377
2018,32260,660,737,13150,13444,51,6.982,38,5.202,1180,561,619,4.173,8.777,1735,250,1485,1.86,12.905,-555,-4.128,17.554,30,30,193
2018,32280,475,529,7769,7830,38,7.204,35,6.635,726,176,550,2.248,9.272,851,251,600,3.206,10.868,-125,-1.596,18.544,30,30,234
2018,32300,1060,1236,20099,20167,75,6.017,96,7.702,1912,367,1545,1.82,9.481,2013,518,1495,2.569,9.982,-101,-0.501,18.962,74,74,334
2018,32340,407,435,5886,5854,31,7.118,32,7.348,534,106,428,1.811,9.122,470,99,371,1.691,8.029,64,1.093,16.057,25,25,59
2018,32380,1265,1483,22042,21822,116,7.883,93,6.32,2465,630,1835,2.887,11.296,1960,361,1599,1.654,8.982,505,2.314,17.964,66,67,196
2018,32460,571,624,9495,9716,29,4.585,46,7.273,1138,412,726,4.24,11.713,1558,415,1143,4.271,16.035,-420,-4.323,23.425,35,36,171
2018,32500,374,403,6926,6886,24,6,18,4.5,557,101,456,1.467,8.089,465,68,397,0.988,6.753,92,1.336,13.507,14,14,56
2018,32540,784,866,10883,10766,56,6.389,77,8.785,1271,349,922,3.242,11.806,1063,354,709,3.288,9.874,208,1.932,19.747,62,63,302
2018,32580,8986,11378,205419,202403,1186,10.5,1020,9.031,29306,9033,20273,4.463,14.479,23022,6043,16979,2.986,11.374,6284,3.105,22.749,763,788,4288
2018,32620,942,1056,14506,14431,85,8.13,64,6.121,1552,352,1200,2.439,10.755,1390,254,1136,1.76,9.632,162,1.123,19.265,54,54,211
2018,32660,634,695,10613,10824,43,6.218,36,5.206,986,211,775,1.949,9.109,1413,193,1220,1.783,13.054,-427,-3.945,18.219,31,31,109
2018,32700,759,834,14029,13822,62,7.447,59,7.087,1481,415,1066,3.003,10.715,1000,229,771,1.657,7.235,481,3.48,14.47,48,48,179
2018,32740,1591,1801,27134,27071,95,5.211,139,7.625,2379,377,2002,1.393,8.788,2321,687,1634,2.538,8.574,58,0.214,17.148,107,107,489
2018,32780,5072,5804,79098,78008,565,9.822,462,8.031,10600,2872,7728,3.682,13.588,8598,2507,6091,3.214,11.022,2002,2.566,22.044,354,361,1829
2018,32820,17471,23979,554174,552095,1882,7.863,1791,7.483,65201,19609,45592,3.552,11.81,60704,20890,39814,3.784,10.995,4497,0.815,21.99,1191,1254,10947
2018,32860,740,814,14438,14421,60,7.29,78,9.478,1175,255,920,1.768,8.148,1156,231,925,1.602,8.016,19,0.132,16.032,64,64,186
2018,32900,2431,2838,45807,45139,283,10.041,244,8.657,5661,2385,3276,5.284,12.541,4424,1228,3196,2.72,9.801,1237,2.74,19.602,195,196,837
2018,32940,1786,2098,32020,32507,123,5.845,136,6.462,3650,1216,2434,3.741,11.228,4606,1339,3267,4.119,14.169,-956,-2.941,22.457,93,96,635
2018,32980,563,624,8869,8772,45,7.223,43,6.902,731,256,475,2.918,8.333,541,151,390,1.721,6.167,190,2.166,12.335,35,35,119
2018,33020,436,486,6614,6738,25,5.071,39,7.911,676,165,511,2.449,10.033,951,207,744,3.072,14.114,-275,-4.081,20.065,33,33,189
2018,33060,493,539,9127,9276,42,7.778,44,8.148,799,294,505,3.169,8.614,1132,641,491,6.91,12.204,-333,-3.59,17.227,35,35,262
2018,33100,146900,170408,2613004,2577526,20770,12.258,18829,11.113,346936,127099,219837,4.931,13.46,276173,99428,176745,3.857,10.715,70763,2.745,21.429,14659,14809,65692
2018,33140,1852,2107,36520,36111,139,6.583,148,7.009,4922,926,3996,2.564,13.63,4077,1553,2524,4.301,11.29,845,2.34,22.581,96,99,771
2018,33180,379,434,6858,6883,25,5.701,34,7.754,776,211,565,3.066,11.274,857,156,701,2.266,12.451,-81,-1.177,22.548,28,28,116
2018,33220,1575,1758,34661,35587,121,6.783,173,9.697,3770,665,3105,1.869,10.594,5466,3561,1905,10.007,15.36,-1696,-4.766,21.188,135,135,345
2018,33260,4441,5141,97330,92069,538,10.642,367,7.259,20182,4985,15197,5.414,21.921,9697,4077,5620,4.428,10.532,10485,11.388,21.065,276,279,2643
2018,33300,745,810,14429,14297,65,8.035,63,7.787,1942,653,1289,4.568,13.584,1641,904,737,6.323,11.478,301,2.105,22.957,53,53,742
2018,33340,27339,35328,815695,809028,2782,7.875,2782,7.875,94437,29178,65259,3.607,11.673,81076,24161,56915,2.986,10.021,13361,1.651,20.043,1853,1908,11105
2018,33420,546,570,5986,5823,54,9.549,45,7.958,934,332,602,5.702,16.04,604,240,364,4.122,10.373,330,5.667,20.745,36,36,192
2018,33460,66042,85182,1934599,1896628,7204,8.451,7321,8.589,262555,93572,168983,4.934,13.843,185853,61882,123971,3.263,9.799,76702,4.044,19.598,5208,5342,38413
2018,33500,1832,2045,27064,27307,148,7.16,192,9.289,2822,772,2050,2.827,10.335,3321,1068,2253,3.911,12.162,-499,-1.827,20.669,138,138,737
2018,33540,3650,4004,50589,50250,342,8.574,312,7.822,6072,2251,3821,4.48,12.084,5430,1439,3991,2.864,10.806,642,1.278,21.612,237,238,1091
2018,33580,683,732,10873,10830,39,5.328,39,5.328,1036,214,822,1.976,9.566,952,248,704,2.29,8.79,84,0.776,17.581,33,33,183
2018,33620,478,513,7700,7579,43,8.382,43,8.382,956,201,755,2.652,12.615,730,237,493,3.127,9.633,226,2.982,19.265,34,34,190
2018,33660,6529,8190,165448,162291,589,7.188,597,7.286,23077,6094,16983,3.755,14.22,17004,4185,12819,2.579,10.478,6073,3.742,20.955,406,409,2174
2018,33700,6917,8374,149171,148112,734,8.8,668,8.009,16478,3647,12831,2.462,11.125,14344,4105,10239,2.772,9.685,2134,1.441,19.369,504,513,2269
2018,33740,3605,4251,66997,67302,310,7.29,313,7.36,7210,2171,5039,3.226,10.713,7880,2787,5093,4.141,11.709,-670,-0.996,21.426,225,235,2092
2018,33780,1879,2106,37030,37035,141,6.638,177,8.333,3854,1034,2820,2.792,10.406,3811,901,2910,2.433,10.29,43,0.116,20.581,111,115,497
2018,33860,5681,7210,134033,133174,493,6.821,529,7.319,14592,4107,10485,3.084,10.957,12979,3526,9453,2.648,9.746,1613,1.211,19.492,353,372,1893
2018,33940,1088,1158,12733,12639,116,10.109,95,8.279,1491,484,1007,3.83,11.797,1285,452,833,3.576,10.167,206,1.63,20.335,83,83,331
2018,33980,1634,1807,20052,19820,153,8.46,156,8.626,2526,848,1678,4.279,12.745,2045,711,1334,3.587,10.318,481,2.427,20.636,119,123,542
2018,34020,954,1114,18730,18669,63,5.553,104,9.167,2520,1042,1478,5.582,13.499,2375,811,1564,4.344,12.722,145,0.777,25.444,85,87,723
2018,34060,2232,2683,53284,53332,218,8.103,233,8.66,6295,1766,4529,3.311,11.804,6478,1528,4950,2.865,12.147,-183,-0.343,23.607,185,189,1187
2018,34100,1590,1891,41464,40486,154,8.224,117,6.248,5170,1230,3940,3.038,12.77,3198,693,2505,1.712,7.899,1972,4.871,15.798,90,93,606
2018,34140,801,843,8965,8939,76,9.096,61,7.301,1033,373,660,4.173,11.557,988,189,799,2.114,11.053,45,0.503,22.107,50,53,161
2018,34180,1521,1682,23032,22465,149,8.901,133,7.945,3419,1392,2027,6.196,15.22,2200,661,1539,2.942,9.793,1219,5.426,19.586,98,99,499
2018,34220,761,809,11752,11678,57,7.046,57,7.046,1365,628,737,5.378,11.689,1208,491,717,4.204,10.344,157,1.344,20.688,44,44,147
2018,34260,903,985,13483,13393,82,8.436,56,5.761,1453,373,1080,2.785,10.849,1270,335,935,2.501,9.483,183,1.366,18.966,43,43,187
2018,34300,382,409,4124,4059,34,8.374,28,6.897,477,116,361,2.858,11.753,338,82,256,2.02,8.328,139,3.425,16.656,25,25,61
2018,34340,1337,1532,29468,28933,94,6.104,110,7.143,3794,618,3176,2.136,13.113,2784,610,2174,2.108,9.622,1010,3.491,19.245,72,75,331
2018,34380,1052,1252,24835,24945,67,5.332,76,6.049,2075,380,1695,1.523,8.318,2260,747,1513,2.995,9.06,-185,-0.742,16.637,53,56,312
2018,34420,542,580,14262,13885,44,7.541,51,8.74,2220,339,1881,2.442,15.989,1514,238,1276,1.714,10.904,706,5.085,21.808,39,39,151
2018,34460,597,657,11551,11751,44,6.697,44,6.697,775,155,620,1.319,6.595,1201,299,902,2.545,10.221,-426,-3.625,13.191,34,34,159
2018,34500,789,884,17798,18121,45,5.042,62,6.947,1225,266,959,1.468,6.76,1859,434,1425,2.395,10.259,-634,-3.499,13.521,48,48,377
2018,34540,889,1008,19461,19168,69,6.815,78,7.704,2077,475,1602,2.478,10.836,1544,350,1194,1.826,8.055,533,2.781,16.111,53,54,283
2018,34580,2947,3222,43734,43345,282,8.8,247,7.708,5012,1121,3891,2.586,11.563,4166,925,3241,2.134,9.611,846,1.952,19.223,178,183,707
2018,34620,1791,2246,42065,42266,136,5.996,180,7.937,4701,930,3771,2.2,11.122,5056,1795,3261,4.247,11.962,-355,-0.84,22.245,108,117,976
2018,34660,730,781,13982,13953,57,7.336,49,6.306,1034,278,756,1.992,7.411,969,287,682,2.057,6.945,65,0.466,13.89,40,40,263
2018,34700,787,887,21901,21928,49,5.524,49,5.524,1525,678,847,3.092,6.955,1589,197,1392,0.898,7.246,-64,-0.292,13.909,36,36,77
2018,34740,2395,2840,56550,54405,184,6.439,219,7.664,11122,6138,4984,11.282,20.443,7076,2168,4908,3.985,13.006,4046,7.437,26.013,167,183,1632
2018,34780,1148,1302,23526,23140,103,7.872,116,8.865,3338,1536,1802,6.638,14.425,2528,797,1731,3.444,10.925,810,3.5,21.85,73,78,378
2018,34820,8715,10551,141032,139517,1120,10.725,904,8.657,20579,7554,13025,5.414,14.75,17531,7062,10469,5.062,12.566,3048,2.185,25.131,683,698,3603
2018,34860,1085,1192,18397,18114,93,7.795,95,7.963,2284,608,1676,3.357,12.609,1703,587,1116,3.241,9.402,581,3.207,18.803,71,71,417
2018,34900,3597,3921,66632,65956,345,8.852,298,7.646,8281,2784,5497,4.221,12.555,6956,2605,4351,3.95,10.547,1325,2.009,21.093,238,248,2307
2018,34940,9644,10766,139580,139134,1257,11.814,1004,9.437,16249,5923,10326,4.257,11.679,15482,4861,10621,3.494,11.127,767,0.551,22.255,779,786,3427
2018,34980,30808,40748,892396,880465,3848,9.506,3308,8.172,111169,32638,78531,3.707,12.626,87788,28253,59535,3.209,9.971,23381,2.656,19.941,2303,2420,15708
2018,35020,947,1078,14345,14085,71,6.568,77,7.123,2019,636,1383,4.516,14.335,1489,421,1068,2.989,10.572,530,3.763,21.144,59,59,280
2018,35060,682,754,11368,11215,52,6.919,47,6.254,1326,258,1068,2.301,11.824,976,181,795,1.614,8.703,350,3.121,17.406,38,38,109
2018,35100,1978,2315,31337,31322,171,7.383,173,7.47,2698,823,1875,2.628,8.614,2718,804,1914,2.567,8.678,-20,-0.064,17.228,121,124,530
2018,35140,659,703,12489,12103,53,7.609,40,5.743,1857,822,1035,6.792,15.343,1034,265,769,2.19,8.543,823,6.8,17.087,31,32,217
2018,35220,687,771,11164,11453,47,6.061,56,7.221,1086,203,883,1.772,9.482,1625,695,930,6.068,14.188,-539,-4.706,18.964,35,35,186
2018,35260,1543,1777,25815,25964,99,5.551,112,6.28,2351,616,1735,2.373,9.055,2638,915,1723,3.524,10.16,-287,-1.105,18.11,79,80,639
2018,35300,14733,17789,340784,341385,1304,7.3,1452,8.129,33241,9381,23860,2.748,9.737,34717,10630,24087,3.114,10.169,-1476,-0.432,19.474,1009,1023,6278
2018,35380,22777,28411,506816,505860,2293,8.07,2302,8.101,58734,16777,41957,3.317,11.611,56724,16257,40467,3.214,11.213,2010,0.397,22.427,1662,1738,10277
2018,35420,1766,1994,29139,29614,126,6.313,130,6.513,2844,527,2317,1.78,9.604,3805,1290,2515,4.356,12.849,-961,-3.245,19.207,98,102,569
2018,35440,1301,1416,14604,14631,110,7.755,115,8.107,1567,463,1104,3.165,10.711,1643,546,1097,3.732,11.23,-76,-0.519,21.421,91,92,427
2018,35460,406,434,5933,5975,27,6.129,40,9.081,571,102,469,1.707,9.557,637,230,407,3.85,10.662,-66,-1.105,19.115,32,32,135
2018,35500,632,695,9230,9163,50,7.262,37,5.374,932,255,677,2.783,10.171,795,156,639,1.702,8.676,137,1.495,17.352,26,26,110
2018,35580,639,719,13337,13221,45,6.263,44,6.124,1269,182,1087,1.377,9.598,1014,279,735,2.11,7.67,255,1.929,15.339,34,36,252
2018,35620,441379,515218,8726302,8653906,50742,9.858,49769,9.669,1130395,363849,766546,4.204,13.062,986254,327702,658552,3.787,11.397,144141,1.666,22.793,38808,39359,204852
2018,35660,2759,3230,55095,54799,203,6.283,205,6.345,5592,1859,3733,3.392,10.205,5067,1153,3914,2.104,9.247,525,0.958,18.493,160,160,926
2018,35700,1008,1071,11585,11766,75,6.954,90,8.345,1335,420,915,3.57,11.347,1693,747,946,6.349,14.39,-358,-3.043,22.693,75,75,400
2018,35740,1368,1502,20547,20689,70,4.611,102,6.719,1776,480,1296,2.32,8.584,2092,690,1402,3.335,10.112,-316,-1.527,17.169,71,72,528
2018,35820,913,1003,12056,12171,71,7.047,80,7.94,1200,327,873,2.687,9.86,1449,545,904,4.478,11.906,-249,-2.046,19.72,61,61,217
2018,35840,17683,20601,320539,321579,2302,11.25,2025,9.896,54908,20624,34284,6.413,17.075,56357,31368,24989,9.754,17.525,-1449,-0.451,34.149,1560,1585,8134
2018,35860,335,384,6352,6267,23,5.99,23,5.99,754,92,662,1.468,12.031,578,247,331,3.941,9.223,176,2.808,18.446,14,15,60
2018,35900,974,1110,18872,19055,68,6.132,66,5.951,1781,342,1439,1.795,9.347,2160,1191,969,6.25,11.336,-379,-1.989,18.694,49,50,954
2018,35940,901,1012,18104,17905,58,5.678,77,7.538,1953,517,1436,2.887,10.908,1575,414,1161,2.312,8.796,378,2.111,17.593,56,56,289
2018,35980,4466,5405,105881,105598,444,8.233,420,7.788,9732,3207,6525,3.037,9.216,9113,3243,5870,3.071,8.63,619,0.586,17.26,301,307,2132
2018,36020,1465,1581,13131,12811,186,11.881,155,9.901,1976,698,1278,5.449,15.425,1351,582,769,4.543,10.546,625,4.879,21.092,114,114,357
2018,36100,5736,6539,85957,84592,646,9.899,620,9.5,11980,3950,8030,4.669,14.162,9171,3762,5409,4.447,10.842,2809,3.321,21.683,463,476,2488
2018,36140,2486,2793,27061,26985,229,8.165,252,8.986,4275,1535,2740,5.688,15.842,4234,1192,3042,4.417,15.69,41,0.152,31.38,192,195,594
2018,36220,2950,3438,66761,62834,351,10.337,266,7.834,14871,3492,11379,5.558,23.667,6903,2692,4211,4.284,10.986,7968,12.681,21.972,193,194,1297
2018,36260,10726,12541,201244,198030,1346,10.86,1052,8.488,27333,9999,17334,5.049,13.802,20779,6560,14219,3.313,10.493,6554,3.31,20.986,777,783,3982
2018,36300,1367,1711,26129,26243,115,6.707,122,7.116,2154,505,1649,1.924,8.208,2362,451,1911,1.719,9.001,-208,-0.793,16.416,83,86,354
2018,36340,898,1063,15110,14929,64,6.021,64,6.021,1429,379,1050,2.539,9.572,1050,353,697,2.365,7.034,379,2.539,14.067,48,48,218
2018,36380,707,754,7303,7287,69,9.145,70,9.278,1009,432,577,5.929,13.848,993,489,504,6.711,13.628,16,0.22,27.256,60,60,242
2018,36420,26366,32466,534691,531242,2936,9.046,2917,8.987,68053,21965,46088,4.135,12.81,61553,19614,41939,3.692,11.587,6500,1.224,23.173,2123,2169,11130
2018,36460,1265,1450,20915,21275,102,7.025,106,7.3,1890,532,1358,2.501,8.884,2608,675,1933,3.173,12.259,-718,-3.375,17.768,84,85,383
2018,36500,5059,5692,75277,74255,523,9.251,446,7.889,9569,3090,6479,4.161,12.887,7496,2659,4837,3.581,10.095,2073,2.792,20.19,338,343,1941
2018,36540,17094,21417,446998,442963,1793,8.368,1815,8.47,53704,14482,39222,3.269,12.124,45574,17378,28196,3.923,10.288,8130,1.835,20.577,1206,1239,7219
2018,36580,1030,1210,19110,18843,71,5.822,90,7.38,2044,440,1604,2.335,10.848,1491,332,1159,1.762,7.913,553,2.935,15.826,67,67,232
2018,36620,1022,1123,13648,13611,101,9.099,75,6.757,1796,594,1202,4.364,13.195,1729,554,1175,4.07,12.703,67,0.492,25.406,59,59,421
2018,36660,1285,1499,22459,22250,84,5.578,98,6.507,2383,769,1614,3.456,10.71,2042,833,1209,3.744,9.178,341,1.533,18.355,74,74,243
2018,36700,1289,1512,24784,25242,95,6.289,92,6.091,2726,768,1958,3.043,10.8,3688,667,3021,2.642,14.611,-962,-3.811,21.599,77,77,496
2018,36740,46980,58752,1154014,1134518,7286,12.547,5920,10.195,157651,55474,102177,4.89,13.896,118559,40175,78384,3.541,10.45,39092,3.446,20.9,4336,4428,23838
2018,36780,2744,3334,87330,86495,226,6.802,203,6.11,7984,1162,6822,1.343,9.231,6252,1255,4997,1.451,7.228,1732,2.002,14.456,140,144,804
2018,36820,463,493,6413,6391,32,6.478,34,6.883,528,73,455,1.142,8.262,484,177,307,2.77,7.573,44,0.688,15.146,29,29,117
2018,36830,298,313,4463,4524,28,8.931,29,9.25,450,121,329,2.675,9.947,597,94,503,2.078,13.196,-147,-3.249,19.894,24,24,78
2018,36840,473,518,8544,8429,32,6.061,52,9.848,934,149,785,1.768,11.081,687,269,418,3.192,8.151,247,2.931,16.302,37,37,100
2018,36860,2710,3183,47765,47984,195,6.096,227,7.096,4733,1217,3516,2.536,9.864,5194,1743,3451,3.632,10.824,-461,-0.961,19.727,168,169,778
2018,36900,759,857,15741,15560,50,5.797,61,7.072,1453,258,1195,1.658,9.338,1085,388,697,2.494,6.973,368,2.365,13.946,51,51,289
2018,36940,823,922,19742,19672,60,6.497,63,6.822,1621,410,1211,2.084,8.24,1497,472,1025,2.399,7.61,124,0.63,15.22,42,42,174
2018,36980,2023,2438,45991,46796,157,6.423,170,6.954,4156,1424,2732,3.043,8.881,5645,951,4694,2.032,12.063,-1489,-3.182,17.762,126,126,744
2018,37020,952,1050,13725,13408,80,7.637,75,7.16,1799,394,1405,2.939,13.417,1117,276,841,2.058,8.331,682,5.087,16.662,61,62,215
2018,37060,1105,1189,17968,17653,122,10.339,104,8.814,2576,919,1657,5.206,14.592,2004,712,1292,4.033,11.352,572,3.24,22.704,80,80,338
2018,37080,755,822,15752,15180,72,8.77,70,8.526,3159,2308,851,15.204,20.81,2213,811,1402,5.343,14.578,946,6.232,29.157,52,52,258
2018,37100,16083,18695,274062,270912,1738,9.29,1765,9.434,34024,10366,23658,3.826,12.559,27874,10151,17723,3.747,10.289,6150,2.27,20.578,1308,1328,6312
2018,37120,595,682,11441,11352,47,6.763,73,10.504,968,194,774,1.709,8.528,816,309,507,2.722,7.188,152,1.339,14.377,50,51,203
2018,37140,2029,2417,39666,40665,161,6.653,167,6.901,4562,1939,2623,4.768,11.218,6429,1890,4539,4.648,15.81,-1867,-4.591,22.437,112,116,1030
2018,37220,598,641,9701,9485,80,12.729,55,8.751,1111,328,783,3.458,11.713,657,180,477,1.898,6.927,454,4.787,13.853,43,43,147
2018,37260,1012,1125,12128,12155,115,10.204,119,10.559,1581,502,1079,4.13,13.008,1680,832,848,6.845,13.822,-99,-0.815,26.015,97,99,346
2018,37300,760,834,12150,12052,62,7.407,68,8.124,1341,423,918,3.51,11.127,1128,394,734,3.269,9.36,213,1.767,18.72,56,58,308
2018,37340,10986,12944,188034,186561,1418,11.051,1192,9.29,24283,9528,14755,5.107,13.016,21549,6936,14613,3.718,11.551,2734,1.465,23.101,891,903,3858
2018,37420,488,517,5865,5823,27,5.182,35,6.718,649,115,534,1.975,11.146,570,132,438,2.267,9.79,79,1.357,19.579,28,28,83
2018,37460,3868,4582,64794,64740,414,9.057,392,8.576,7103,2739,4364,4.231,10.972,7065,2249,4816,3.474,10.913,38,0.059,21.826,281,287,1334
2018,37500,686,743,20111,19214,62,8.435,46,6.259,2865,364,2501,1.894,14.911,909,305,604,1.587,4.731,1956,10.18,9.462,39,39,269
2018,37540,604,654,9389,9572,41,6.236,48,7.3,928,281,647,2.936,9.695,1350,227,1123,2.372,14.104,-422,-4.409,19.39,37,37,180
2018,37580,1052,1136,18106,17798,98,8.684,83,7.355,2345,968,1377,5.439,13.176,1700,628,1072,3.529,9.552,645,3.624,19.104,67,72,491
2018,37620,1583,1883,30554,30387,103,5.411,144,7.565,3854,1276,2578,4.199,12.683,3534,1447,2087,4.762,11.63,320,1.053,23.26,97,97,500
2018,37660,370,423,7489,7532,22,5.189,24,5.66,698,64,634,0.85,9.267,795,252,543,3.346,10.555,-97,-1.288,18.534,19,19,78
2018,37740,827,929,11198,11071,70,7.511,76,8.155,1365,701,664,6.332,12.33,1135,398,737,3.595,10.252,230,2.077,20.504,54,54,232
2018,37780,278,309,5314,4602,47,16.041,15,5.119,1986,491,1495,10.669,43.155,533,151,382,3.281,11.582,1453,31.573,23.164,11,11,38
2018,37860,7022,8753,161013,158207,876,10.056,793,9.103,21121,7041,14080,4.45,13.35,15571,5127,10444,3.241,9.842,5550,3.508,19.684,566,570,2987
2018,37900,6132,7628,162012,159650,518,6.781,541,7.082,18007,4102,13905,2.569,11.279,13019,3804,9215,2.383,8.155,4988,3.124,16.309,398,416,2382
2018,37940,489,532,6666,6876,32,5.953,43,8,580,144,436,2.094,8.436,1034,520,514,7.563,15.039,-454,-6.603,16.872,28,28,216
2018,37980,105510,135067,2732046,2701585,11566,8.578,11094,8.228,350229,108184,242045,4.004,12.964,288995,88788,200207,3.287,10.697,61234,2.267,21.394,7865,8011,44752
2018,38060,66287,87321,1903383,1857390,9619,11.113,8086,9.342,283214,88660,194554,4.773,15.248,190802,54533,136269,2.936,10.273,92412,4.975,20.545,5800,5972,33085
2018,38100,682,756,8223,8193,54,7.167,49,6.503,904,239,665,2.917,11.034,838,287,551,3.503,10.229,66,0.806,20.458,34,34,176
2018,38180,718,771,8244,8304,64,8.279,68,8.797,846,341,505,4.107,10.188,945,404,541,4.865,11.381,-99,-1.192,20.377,49,49,299
2018,38220,1244,1424,21847,21768,99,6.96,96,6.749,2012,522,1490,2.398,9.243,1833,565,1268,2.596,8.421,179,0.822,16.841,69,73,295
2018,38240,1869,2077,32272,31613,194,9.411,163,7.907,3723,1218,2505,3.853,11.777,2459,855,1604,2.705,7.778,1264,3.998,15.557,128,128,480
2018,38260,728,876,14622,14732,47,5.35,52,5.919,1150,237,913,1.609,7.806,1362,455,907,3.089,9.245,-212,-1.439,15.613,38,38,397
2018,38300,41045,54869,1110644,1110616,3781,6.883,3905,7.109,115736,31773,83963,2.861,10.421,115089,30333,84756,2.731,10.363,647,0.058,20.725,2624,2721,14587
2018,38340,2947,3376,53322,53556,186,5.425,291,8.488,5322,1022,4300,1.908,9.937,5925,1820,4105,3.398,11.063,-603,-1.126,19.875,206,207,1168
2018,38380,575,626,9424,9201,37,5.868,46,7.296,1211,168,1043,1.826,13.162,798,138,660,1.5,8.673,413,4.489,17.346,31,31,65
2018,38420,979,1112,14028,13894,64,5.725,76,6.798,1629,240,1389,1.727,11.724,1371,380,991,2.735,9.868,258,1.857,19.735,57,57,205
2018,38460,1450,1682,24880,24893,121,7.198,119,7.079,2354,367,1987,1.474,9.456,2410,667,1743,2.679,9.681,-56,-0.225,18.913,86,86,374
2018,38500,928,1010,17718,17756,76,7.627,49,4.917,1789,605,1184,3.407,10.076,1853,447,1406,2.518,10.436,-64,-0.36,20.152,34,35,218
2018,38540,1667,1866,24664,24645,143,7.68,135,7.25,2609,723,1886,2.934,10.586,2533,920,1613,3.733,10.278,76,0.308,20.556,102,104,538
2018,38580,700,822,13320,13336,51,6.201,52,6.322,1388,439,949,3.292,10.408,1412,382,1030,2.865,10.588,-24,-0.18,20.817,38,38,231
2018,38620,900,1016,14923,14962,52,5.093,62,6.072,1551,270,1281,1.805,10.367,1622,333,1289,2.226,10.841,-71,-0.475,20.733,47,47,212
2018,38700,698,791,11233,11077,42,5.293,47,5.923,1260,240,1020,2.167,11.375,929,331,598,2.988,8.387,331,2.988,16.774,39,39,292
2018,38740,976,1048,15679,15731,90,8.515,108,10.218,1725,759,966,4.825,10.966,1817,674,1143,4.285,11.551,-92,-0.585,21.932,91,93,487
2018,38780,275,297,3233,3349,22,7.333,28,9.333,216,65,151,1.941,6.45,457,136,321,4.061,13.646,-241,-7.196,12.899,24,25,131
2018,38820,1758,1862,18070,17919,193,10.521,138,7.522,2308,761,1547,4.247,12.881,1932,979,953,5.464,10.782,376,2.098,21.564,113,113,544
2018,38840,769,859,10282,10326,54,6.254,63,7.296,839,185,654,1.792,8.126,912,323,589,3.128,8.833,-73,-0.707,16.251,43,44,213
2018,38860,13339,15897,241575,239619,1281,8.081,1192,7.519,27154,5955,21199,2.485,11.332,23278,6461,16817,2.696,9.715,3876,1.618,19.429,861,879,4437
2018,38900,51798,63904,1080334,1068084,6301,9.932,5380,8.48,136667,38221,98446,3.578,12.796,112737,38325,74412,3.588,10.555,23930,2.24,21.11,3952,4012,21451
2018,38920,376,393,8184,8274,23,5.793,31,7.809,704,113,591,1.366,8.509,838,213,625,2.574,10.128,-134,-1.62,17.017,25,25,131
2018,38940,9043,10272,125433,122544,1157,11.377,952,9.361,18960,6655,12305,5.431,15.472,13390,5115,8275,4.174,10.927,5570,4.545,21.853,738,761,3528
2018,39020,1008,1185,19402,19343,66,5.556,72,6.061,2221,581,1640,3.004,11.482,2084,910,1174,4.705,10.774,137,0.708,21.548,55,57,451
2018,39060,2147,2537,40998,40884,146,5.737,162,6.365,3604,812,2792,1.986,8.815,3358,970,2388,2.373,8.213,246,0.602,16.427,116,120,519
2018,39140,4674,5275,62115,61484,525,10.032,442,8.446,8540,3010,5530,4.896,13.89,7229,2523,4706,4.104,11.758,1311,2.132,23.515,345,352,1798
2018,39220,419,443,6148,5927,30,6.674,43,9.566,1146,583,563,9.837,19.337,665,277,388,4.674,11.221,481,8.116,22.442,31,31,197
2018,39260,456,474,4113,4194,53,11.277,45,9.574,543,157,386,3.744,12.949,733,168,565,4.006,17.479,-190,-4.531,25.897,37,38,115
2018,39300,30517,37130,643072,642122,2929,7.881,3003,8.08,73002,19996,53006,3.114,11.369,70515,24099,46416,3.753,10.982,2487,0.387,21.963,2077,2140,12346
2018,39340,10447,11803,261132,252842,1637,14.16,1152,9.965,40300,12653,27647,5.004,15.939,24011,9196,14815,3.637,9.496,16289,6.442,18.993,921,937,6516
2018,39380,2544,2905,50833,50835,256,8.873,216,7.487,5460,1402,4058,2.758,10.741,5418,1265,4153,2.488,10.658,42,0.083,21.316,166,169,998
2018,39420,679,753,11095,10821,47,6.221,52,6.883,1499,455,1044,4.205,13.853,947,204,743,1.885,8.752,552,5.101,17.503,38,38,161
2018,39460,3180,3575,50544,50034,334,9.343,334,9.343,7467,1530,5937,3.058,14.924,6533,3636,2897,7.267,13.057,934,1.867,26.114,273,277,3048
2018,39500,1617,1814,33479,33452,100,5.469,129,7.055,3659,1060,2599,3.169,10.938,3668,1146,2522,3.426,10.965,-9,-0.027,21.876,88,92,802
2018,39540,3214,3656,68263,67278,255,6.962,268,7.317,8179,2071,6108,3.078,12.157,6173,1944,4229,2.89,9.175,2006,2.982,18.351,197,200,1152
2018,39580,24681,30565,543046,536069,3234,10.676,2688,8.874,74334,23057,51277,4.301,13.866,60516,20716,39800,3.864,11.289,13818,2.578,22.578,1962,2003,11917
2018,39660,3748,4255,55702,55941,376,8.84,373,8.769,6434,2000,4434,3.575,11.501,6880,2465,4415,4.406,12.299,-446,-0.797,23.003,271,281,1467
2018,39700,161,178,2127,2092,18,10.084,19,10.644,429,301,128,14.388,20.507,335,223,112,10.66,16.013,94,4.493,32.027,16,16,37
2018,39740,6505,7779,157289,156506,467,5.978,534,6.835,16166,3549,12617,2.268,10.329,14467,3498,10969,2.235,9.244,1699,1.086,18.488,371,381,2341
2018,39780,789,882,12507,12422,80,9.081,78,8.854,1209,324,885,2.608,9.733,1042,370,672,2.979,8.389,167,1.344,16.777,61,62,241
2018,39820,3413,3832,53806,52826,332,8.702,298,7.811,6921,1950,4971,3.691,13.102,4969,1552,3417,2.938,9.406,1952,3.695,18.813,234,234,1033
2018,39860,1030,1150,20748,20686,64,5.503,90,7.739,1712,294,1418,1.421,8.276,1610,472,1138,2.282,7.783,102,0.493,15.566,64,66,201
2018,39900,9829,11575,209504,206222,1160,10.086,1012,8.799,29000,8299,20701,4.024,14.063,22450,6259,16191,3.035,10.886,6550,3.176,21.773,714,731,4035
2018,39940,933,986,20443,20260,106,10.872,84,8.615,1926,496,1430,2.448,9.506,1577,550,1027,2.715,7.784,349,1.723,15.568,62,63,302
2018,39980,1115,1334,27156,26515,80,5.961,96,7.154,3496,960,2536,3.621,13.185,2201,781,1420,2.946,8.301,1295,4.884,16.602,59,59,444
2018,40060,23023,29396,562766,555398,2510,8.564,2334,7.964,72056,22107,49949,3.98,12.974,57462,18500,38962,3.331,10.346,14594,2.628,20.692,1644,1675,10172
2018,40080,1523,1738,27814,27013,138,8.035,97,5.648,3406,1011,2395,3.743,12.609,1853,300,1553,1.111,6.86,1553,5.749,13.719,75,75,222
2018,40100,468,540,9271,8964,37,6.877,33,6.134,1307,308,999,3.436,14.581,752,109,643,1.216,8.389,555,6.191,16.778,22,23,76
2018,40140,54126,68127,1276557,1257760,7531,11.179,6006,8.916,170610,57272,113338,4.553,13.565,133416,39921,93495,3.174,10.607,37194,2.957,21.215,4592,4710,27398
2018,40180,1059,1145,10091,10124,128,11.263,111,9.767,1227,388,839,3.833,12.12,1314,447,867,4.415,12.98,-87,-0.859,24.241,89,89,282
2018,40220,6141,7530,146761,143365,548,7.283,536,7.124,18724,3375,15349,2.354,13.06,12374,4053,8321,2.827,8.631,6350,4.429,17.262,380,390,1853
2018,40260,948,1137,17022,16766,73,6.446,64,5.651,1963,702,1261,4.187,11.708,1445,253,1192,1.509,8.619,518,3.09,17.237,52,52,156
2018,40300,852,946,14301,14039,65,6.871,65,6.871,2307,1084,1223,7.721,16.433,1730,263,1467,1.873,12.323,577,4.11,24.646,52,52,229
2018,40340,3890,4587,81479,81828,308,6.691,340,7.386,7208,1989,5219,2.431,8.809,7897,2686,5211,3.282,9.651,-689,-0.842,17.617,240,244,1441
2018,40380,17939,22299,456277,456541,1752,7.845,1820,8.149,45678,10178,35500,2.229,10.005,46235,14460,31775,3.167,10.127,-557,-0.122,20.01,1302,1356,7915
2018,40420,5531,6569,135899,135609,453,6.886,472,7.175,14185,3114,11071,2.296,10.46,13576,4212,9364,3.106,10.011,609,0.449,20.022,362,363,3403
2018,40460,693,760,11516,11287,60,7.91,57,7.515,1550,439,1111,3.889,13.733,1048,317,731,2.809,9.285,502,4.448,18.57,40,42,202
2018,40540,1024,1136,15660,15655,91,7.972,102,8.936,1660,353,1307,2.255,10.604,1621,489,1132,3.124,10.355,39,0.249,20.709,84,84,344
2018,40580,2098,2596,49311,48748,176,6.811,152,5.882,6057,2340,3717,4.8,12.425,4865,1230,3635,2.523,9.98,1192,2.445,19.96,110,111,753
2018,40620,883,978,14172,14309,68,6.89,86,8.713,1325,242,1083,1.691,9.26,1586,459,1127,3.208,11.084,-261,-1.824,18.52,59,59,166
2018,40660,1581,1823,37444,36963,151,8.29,148,8.125,3651,897,2754,2.427,9.878,2709,587,2122,1.588,7.329,942,2.549,14.658,100,110,400
2018,40700,2072,2358,31952,31570,210,8.959,182,7.765,3743,1244,2499,3.94,11.856,3013,960,2053,3.041,9.544,730,2.312,19.088,140,144,670
2018,40740,1136,1269,16608,16354,90,7.042,108,8.451,2042,553,1489,3.382,12.487,1571,547,1024,3.345,9.607,471,2.88,19.213,89,89,304
2018,40780,1480,1698,28159,28197,133,7.856,123,7.265,2669,621,2048,2.202,9.466,2746,972,1774,3.447,9.739,-77,-0.273,18.931,94,97,653
2018,40820,944,1027,15527,15465,79,7.741,66,6.467,1607,513,1094,3.317,10.391,1456,360,1096,2.328,9.415,151,0.976,18.83,52,52,294
2018,40860,1713,1891,24095,23201,121,6.382,131,6.909,3570,1821,1749,7.849,15.387,1917,602,1315,2.595,8.263,1653,7.125,16.525,102,102,435
2018,40900,36039,44849,778932,768023,4648,10.463,3796,8.545,101992,32324,69668,4.209,13.28,80009,24098,55911,3.138,10.418,21983,2.862,20.835,2793,2854,15641
2018,40940,439,474,7339,7361,45,9.554,39,8.28,699,162,537,2.201,9.496,730,163,567,2.214,9.917,-31,-0.421,18.992,30,30,121
2018,40980,3246,3890,81631,81561,220,5.64,241,6.179,7210,1766,5444,2.165,8.84,7095,2144,4951,2.629,8.699,115,0.141,17.398,155,164,1211
2018,41060,4193,4863,100614,100690,307,6.292,339,6.948,10005,1949,8056,1.936,9.936,10313,2672,7641,2.654,10.242,-308,-0.306,19.873,231,244,1767
2018,41100,4263,4616,54299,52296,541,11.937,373,8.23,9015,2388,6627,4.566,17.239,5046,1975,3071,3.777,9.649,3969,7.59,19.298,298,301,1692
2018,41140,2221,2602,49279,49217,189,7.31,156,6.034,4844,1117,3727,2.27,9.842,4599,949,3650,1.928,9.344,245,0.498,18.689,113,114,563
2018,41180,49433,65095,1285274,1282420,6129,9.475,5312,8.212,149407,50023,99384,3.901,11.65,143440,41060,102380,3.202,11.185,5967,0.465,22.37,3744,3849,22050
2018,41220,706,771,9402,8976,74,9.73,53,6.969,1677,395,1282,4.401,18.684,862,187,675,2.083,9.604,815,9.08,19.208,40,40,120
2018,41400,1554,1813,26342,26699,111,6.079,137,7.503,2460,684,1776,2.562,9.214,3162,734,2428,2.749,11.843,-702,-2.629,18.428,104,107,637
2018,41420,7564,8895,125538,123345,859,9.762,667,7.58,15931,3993,11938,3.237,12.916,11817,3731,8086,3.025,9.58,4114,3.335,19.161,487,497,2398
2018,41460,1367,1521,27612,28173,91,5.954,106,6.935,2241,653,1588,2.318,7.954,3426,685,2741,2.431,12.161,-1185,-4.206,15.909,78,78,456
2018,41500,6935,7982,116568,115702,726,9.147,636,8.013,15123,4217,10906,3.645,13.071,13529,5304,8225,4.584,11.693,1594,1.378,23.386,465,466,3585
2018,41540,7557,9335,134521,132700,774,8.328,692,7.446,16040,4192,11848,3.159,12.087,12378,3577,8801,2.696,9.328,3662,2.76,18.656,495,503,2581
2018,41620,24108,29575,662201,650720,3101,10.555,2712,9.231,85540,23092,62448,3.549,13.145,62881,22536,40345,3.463,9.663,22659,3.482,19.327,1940,1983,14233
2018,41660,2264,2650,41440,40783,194,7.319,195,7.357,5171,1403,3768,3.44,12.679,3878,1067,2811,2.616,9.509,1293,3.17,19.018,149,152,676
2018,41700,31835,42562,933879,923450,4218,9.95,3881,9.155,126720,39025,87695,4.226,13.722,105476,31932,73544,3.458,11.422,21244,2.301,22.844,2770,2840,18250
2018,41740,62422,75612,1359998,1343819,8169,10.879,7127,9.491,178825,55185,123640,4.107,13.307,146587,44731,101856,3.329,10.908,32238,2.399,21.816,5412,5490,29557
2018,41760,1306,1357,12850,12491,171,12.809,127,9.513,1924,783,1141,6.269,15.404,1240,333,907,2.666,9.928,684,5.476,19.855,104,105,288
2018,41780,1455,1658,31481,31369,102,6.117,121,7.256,3063,929,2134,2.962,9.765,2799,797,2002,2.541,8.923,264,0.842,17.846,92,93,429
2018,41820,1103,1233,25873,24684,98,8.013,78,6.378,3801,387,3414,1.568,15.399,1366,486,880,1.969,5.534,2435,9.865,11.068,61,63,396
2018,41860,95965,117288,2293119,2256797,11267,9.625,10805,9.231,322518,90420,232098,4.007,14.291,248558,84786,163772,3.757,11.014,73960,3.277,22.028,7954,8177,49650
2018,41940,37111,44505,1081637,1072670,4418,9.937,4330,9.739,138149,36314,101835,3.385,12.879,119715,41397,78318,3.859,11.16,18434,1.719,22.321,3267,3319,19160
2018,42020,6683,7580,94569,93230,701,9.285,641,8.49,12243,3418,8825,3.666,13.132,9565,3126,6439,3.353,10.26,2678,2.872,20.519,498,501,1957
2018,42100,5672,6308,79433,79119,551,8.711,586,9.264,9409,2642,6767,3.339,11.892,8870,3149,5721,3.98,11.211,539,0.681,22.422,455,461,2301
2018,42140,3894,4253,45797,46349,372,8.785,335,7.911,5411,1482,3929,3.198,11.675,6446,1810,4636,3.905,13.908,-1035,-2.233,23.349,244,248,1078
2018,42200,9328,10698,154021,151864,937,8.778,890,8.338,20910,6779,14131,4.464,13.769,16572,5837,10735,3.844,10.912,4338,2.857,21.825,664,672,3746
2018,42220,11279,12872,178401,178315,1118,8.689,1108,8.611,23482,7225,16257,4.052,13.169,23212,6430,16782,3.606,13.017,270,0.151,26.035,849,864,3858
2018,42300,616,689,8625,8508,56,8.193,45,6.584,1085,270,815,3.174,12.753,812,325,487,3.82,9.545,273,3.209,19.089,24,26,85
2018,42340,7052,8519,164982,164460,801,9.484,655,7.755,20658,5922,14736,3.601,12.561,19686,5348,14338,3.252,11.97,972,0.591,23.94,470,474,2906
2018,42380,1033,1219,18336,18126,70,5.686,94,7.636,1808,454,1354,2.505,9.975,1392,476,916,2.626,7.68,416,2.295,15.359,72,72,284
2018,42420,905,1008,12999,13245,69,6.771,91,8.93,1409,400,1009,3.02,10.638,1870,544,1326,4.107,14.119,-461,-3.481,21.276,67,67,349
2018,42460,716,777,12591,13010,55,7.097,51,6.581,1208,209,999,1.607,9.286,2100,877,1223,6.741,16.142,-892,-6.857,18.571,41,41,171
2018,42540,9431,12010,237190,237163,709,5.869,849,7.028,23221,5143,18078,2.169,9.791,23321,6236,17085,2.629,9.833,-100,-0.042,19.582,610,624,3632
2018,42620,1300,1454,22472,22465,119,8.17,124,8.514,2200,587,1613,2.613,9.793,2161,957,1204,4.26,9.619,39,0.174,19.239,108,111,901
2018,42660,76800,95125,1712373,1687246,9942,10.529,8538,9.042,224052,69270,154782,4.106,13.279,174298,56981,117317,3.377,10.33,49754,2.949,20.661,6286,6482,32132
2018,42680,3566,3881,46381,45747,366,9.423,372,9.578,6285,2475,3810,5.41,13.739,5108,1773,3335,3.876,11.166,1177,2.573,22.332,293,296,1001
2018,42700,1561,1790,20837,20777,154,8.661,130,7.312,2310,878,1432,4.226,11.118,2228,655,1573,3.153,10.724,82,0.395,21.447,98,106,482
2018,42740,852,945,18223,18338,68,7.177,73,7.704,1604,307,1297,1.674,8.747,1823,547,1276,2.983,9.941,-219,-1.194,17.494,53,53,450
2018,42780,735,824,15663,15790,39,4.707,48,5.794,1186,237,949,1.501,7.511,1468,302,1166,1.913,9.297,-282,-1.786,15.023,35,35,141
2018,42820,619,663,9507,9785,40,5.939,61,9.057,942,334,608,3.413,9.627,1523,450,1073,4.599,15.565,-581,-5.938,19.254,43,44,314
2018,42860,1314,1408,19739,19833,132,9.473,103,7.391,3351,1734,1617,8.743,16.897,3506,1997,1509,10.069,17.678,-155,-0.782,33.793,68,69,197
2018,42900,588,648,10387,10448,42,6.481,42,6.481,879,155,724,1.484,8.413,982,220,762,2.106,9.399,-103,-0.986,16.826,29,29,148
2018,42940,2163,2600,42000,41495,200,7.704,192,7.396,5154,1352,3802,3.258,12.421,4262,1146,3116,2.762,10.271,892,2.15,20.542,148,151,936
2018,42980,822,926,21645,21205,63,6.818,59,6.385,2157,409,1748,1.929,10.172,1314,377,937,1.778,6.197,843,3.975,12.393,36,36,118
2018,43020,776,828,11490,11431,45,5.481,31,3.776,1119,157,962,1.374,9.79,1024,164,860,1.435,8.958,95,0.831,17.917,21,21,70
2018,43060,1100,1229,17333,17660,88,7.157,89,7.239,1689,449,1240,2.543,9.564,2330,618,1712,3.5,13.194,-641,-3.63,19.129,69,69,427
2018,43100,2104,2463,54483,53743,139,5.649,134,5.446,4966,1725,3241,3.21,9.24,3558,878,2680,1.634,6.62,1408,2.62,13.241,94,97,425
2018,43140,1562,1777,30455,30205,95,5.304,123,6.868,2958,704,2254,2.331,9.793,2461,782,1679,2.589,8.148,497,1.645,16.296,100,102,595
2018,43180,684,727,14579,14540,60,8.253,60,8.253,1110,252,858,1.733,7.634,1006,395,611,2.717,6.919,104,0.715,13.838,50,50,173
2018,43220,917,952,9635,9467,103,10.94,82,8.71,1300,438,862,4.627,13.732,933,354,579,3.739,9.855,367,3.877,19.711,59,59,173
2018,43260,1075,1113,11017,10954,129,11.829,84,7.703,1521,443,1078,4.044,13.885,1366,533,833,4.866,12.47,155,1.415,24.941,62,62,325
2018,43300,2156,2402,40437,39931,193,8.106,151,6.342,4717,1382,3335,3.461,11.813,3687,976,2711,2.444,9.234,1030,2.579,18.467,111,111,534
2018,43320,1333,1570,19433,19170,139,8.845,142,9.036,2653,1033,1620,5.389,13.84,2133,625,1508,3.26,11.127,520,2.713,22.254,116,118,549
2018,43340,7347,9255,153779,153473,743,8.037,722,7.81,17763,4802,12961,3.129,11.574,17130,4507,12623,2.937,11.162,633,0.412,22.323,501,518,2910
2018,43380,815,915,27008,26643,55,6.074,36,3.976,2406,425,1981,1.595,9.031,1701,220,1481,0.826,6.384,705,2.646,12.769,26,26,145
2018,43420,1662,1979,24907,24864,163,8.195,183,9.201,3275,1034,2241,4.159,13.172,3171,969,2202,3.897,12.754,104,0.418,25.507,125,126,630
2018,43460,893,993,13873,13609,90,9.114,79,8,1721,397,1324,2.917,12.647,1255,354,901,2.601,9.222,466,3.424,18.444,61,61,305
2018,43500,480,526,6540,6755,34,6.331,56,10.428,392,92,300,1.362,5.804,819,203,616,3.005,12.125,-427,-6.322,11.607,40,40,112
2018,43580,3396,4029,80024,79102,242,5.989,266,6.583,9111,1328,7783,1.679,11.518,7177,2205,4972,2.788,9.073,1934,2.445,18.146,197,198,1083
2018,43620,6075,7241,143737,143481,623,8.677,501,6.978,13823,4341,9482,3.025,9.634,13178,3776,9402,2.632,9.185,645,0.45,18.369,369,373,1992
2018,43660,364,399,4943,5334,34,8.575,29,7.314,756,303,453,5.681,14.175,1567,1185,382,22.218,29.38,-811,-15.206,28.349,21,21,181
2018,43700,1157,1304,21936,22485,86,6.598,85,6.521,2611,747,1864,3.322,11.612,3668,725,2943,3.224,16.313,-1057,-4.701,23.224,64,65,567
2018,43740,1374,1529,19573,19317,92,5.97,116,7.528,2241,357,1884,1.848,11.601,1696,415,1281,2.148,8.78,545,2.821,17.56,93,95,285
2018,43760,1078,1140,12705,12752,122,10.744,113,9.952,1464,612,852,4.799,11.481,1541,481,1060,3.772,12.084,-77,-0.604,22.961,94,95,361
2018,43780,4997,6117,129987,129896,452,7.42,401,6.583,13298,3605,9693,2.775,10.237,13085,3196,9889,2.46,10.073,213,0.164,20.147,283,289,2111
2018,43900,5241,6409,152627,148435,518,8.147,416,6.543,20127,5195,14932,3.5,13.56,11879,2850,9029,1.92,8.003,8248,5.557,16.006,303,309,1705
2018,43940,892,945,10037,9909,90,9.636,68,7.281,1147,297,850,2.997,11.576,895,225,670,2.271,9.033,252,2.543,18.065,56,56,188
2018,43980,530,567,7165,7279,42,7.487,30,5.348,711,178,533,2.446,9.768,911,363,548,4.987,12.516,-200,-2.748,19.537,21,21,165
2018,44020,638,674,8380,8220,49,7.243,54,7.982,1170,337,833,4.1,14.234,814,191,623,2.324,9.903,356,4.331,19.807,37,41,145
2018,44060,10658,12905,204772,202858,1226,9.578,1016,7.938,27122,7085,20037,3.493,13.37,23020,8252,14768,4.068,11.348,4102,2.022,22.696,746,757,4513
2018,44100,4019,4784,84940,85152,337,7.049,330,6.903,7353,1882,5471,2.21,8.635,7758,1844,5914,2.166,9.111,-405,-0.476,17.27,242,242,1438
2018,44140,9826,11964,223019,222979,837,6.98,893,7.447,21380,6039,15341,2.708,9.588,21427,5375,16052,2.411,9.609,-47,-0.021,19.177,607,626,2283
2018,44180,8914,10712,192058,187912,1017,9.578,829,7.807,26957,9470,17487,5.04,14.346,18529,5411,13118,2.88,9.86,8428,4.485,19.721,634,645,2987
2018,44220,1783,2073,41123,41720,128,6.149,145,6.966,3411,744,2667,1.783,8.176,4679,863,3816,2.069,11.215,-1268,-3.039,16.352,103,104,450
2018,44260,763,822,12880,12791,46,5.583,50,6.068,1491,377,1114,2.948,11.657,1317,393,924,3.073,10.297,174,1.36,20.593,41,41,371
2018,44300,2641,3122,46325,46180,201,6.453,187,6.003,4944,1169,3775,2.531,10.706,4673,1117,3556,2.419,10.119,271,0.587,20.238,133,135,704
2018,44340,1260,1350,31345,30272,119,8.871,102,7.603,3881,675,3206,2.23,12.821,1728,671,1057,2.217,5.708,2153,7.112,11.417,75,75,360
2018,44420,2278,2585,39759,39827,142,5.464,170,6.541,3229,653,2576,1.64,8.108,3325,962,2363,2.415,8.349,-96,-0.241,16.215,122,122,552
2018,44460,1400,1469,14613,14483,151,10.325,138,9.436,2142,829,1313,5.724,14.79,1863,874,989,6.035,12.864,279,1.926,25.728,110,110,800
2018,44500,867,907,12686,12575,85,9.351,89,9.791,1430,348,1082,2.768,11.372,1221,345,876,2.744,9.71,209,1.662,19.42,70,70,274
2018,44540,498,535,5167,5154,34,6.349,35,6.536,556,210,346,4.075,10.789,550,147,403,2.852,10.672,6,0.116,21.345,25,25,67
2018,44580,994,1107,17790,17645,74,6.67,79,7.12,1820,588,1232,3.332,10.315,1521,401,1120,2.273,8.62,299,1.695,17.24,60,60,232
2018,44620,1358,1580,31011,31112,94,5.927,106,6.683,2412,402,2010,1.292,7.753,2656,867,1789,2.787,8.537,-244,-0.784,15.505,75,75,293
2018,44660,1555,1725,24241,23997,126,7.309,124,7.193,3362,841,2521,3.505,14.01,2891,1005,1886,4.188,12.047,471,1.963,24.095,92,92,699
2018,44700,8788,10637,197951,195942,1000,9.465,857,8.111,22806,6773,16033,3.457,11.639,18727,5508,13219,2.811,9.557,4079,2.082,19.115,623,628,3334
2018,44740,484,519,8931,8817,38,7.379,30,5.825,787,207,580,2.348,8.926,538,184,354,2.087,6.102,249,2.824,12.204,20,21,118
2018,44780,922,1053,20809,20286,67,6.387,59,5.624,2409,259,2150,1.277,11.875,1468,293,1175,1.444,7.237,941,4.639,14.473,47,47,166
2018,44860,639,687,9916,10059,45,6.452,66,9.462,1072,233,839,2.316,10.657,1367,569,798,5.657,13.59,-295,-2.933,21.314,51,51,183
2018,44900,265,284,4740,4866,25,8.818,24,8.466,298,79,219,1.624,6.125,516,73,443,1.5,10.605,-218,-4.481,12.25,16,16,32
2018,44920,1892,2047,29461,28647,261,13.004,181,9.018,5452,2777,2675,9.694,19.032,3657,1663,1994,5.805,12.766,1795,6.266,25.531,130,130,1340
2018,44940,1434,1659,32324,31843,107,6.471,96,5.806,3555,606,2949,1.903,11.164,2670,536,2134,1.683,8.385,885,2.779,16.77,67,67,353
2018,44980,1355,1564,23560,24067,81,5.158,94,5.985,1926,340,1586,1.413,8.003,2868,789,2079,3.278,11.917,-942,-3.914,16.005,62,63,594
2018,45000,337,363,3479,3496,29,8,28,7.724,426,132,294,3.776,12.187,448,92,356,2.632,12.816,-22,-0.629,24.374,21,21,58
2018,45020,311,329,5225,4748,29,8.815,29,8.815,1293,988,305,20.809,27.233,383,65,318,1.369,8.067,910,19.166,16.133,25,25,57
2018,45060,11003,13669,279174,274874,985,7.155,1182,8.585,31754,9528,22226,3.466,11.552,23024,7284,15740,2.65,8.376,8730,3.176,16.752,851,872,4191
2018,45140,603,683,9253,9338,39,5.644,55,7.959,755,175,580,1.874,8.085,920,233,687,2.495,9.852,-165,-1.767,16.17,36,37,141
2018,45180,1068,1272,30079,30796,83,6.507,90,7.056,2757,527,2230,1.711,8.952,4356,640,3716,2.078,14.145,-1599,-5.192,17.905,69,71,312
2018,45220,7065,8277,114487,112349,806,9.777,740,8.976,15774,5626,10148,5.008,14.04,11554,4429,7125,3.942,10.284,4220,3.756,20.568,509,518,2478
2018,45300,56662,70770,1466391,1425002,7950,11.322,6843,9.746,234222,90424,143798,6.346,16.437,148744,53382,95362,3.746,10.438,85478,5.998,20.876,4969,5048,31517
2018,45340,869,920,9093,9005,85,9.214,90,9.756,1377,613,764,6.807,15.292,1226,371,855,4.12,13.615,151,1.677,27.229,71,71,335
2018,45380,581,651,8272,8340,32,4.848,50,7.576,707,78,629,0.935,8.477,819,167,652,2.002,9.82,-112,-1.343,16.954,39,39,125
2018,45460,2675,3245,58220,57900,201,6.153,244,7.47,6116,1873,4243,3.235,10.563,5536,1674,3862,2.891,9.561,580,1.002,19.123,164,165,651
2018,45500,2403,2881,47996,47974,185,6.38,222,7.656,5676,1518,4158,3.164,11.831,5657,1712,3945,3.569,11.792,19,0.04,23.584,160,171,1115
2018,45520,587,633,8387,8604,58,9.199,53,8.406,923,317,606,3.685,10.728,1386,248,1138,2.883,16.11,-463,-5.382,21.456,43,43,181
2018,45540,1251,1426,22811,22573,180,12.834,133,9.483,3326,1245,2081,5.515,14.734,2784,1139,1645,5.046,12.333,542,2.401,24.667,105,107,604
2018,45580,397,423,5644,5631,38,9.102,27,6.467,452,146,306,2.593,8.027,421,80,341,1.421,7.476,31,0.551,14.953,17,17,36
2018,45620,973,1053,17841,17518,84,7.973,85,8.068,2217,608,1609,3.471,12.656,1605,418,1187,2.386,9.162,612,3.494,18.324,64,65,316
2018,45660,888,968,18114,17770,45,4.599,66,6.745,2054,1005,1049,5.656,11.559,1424,218,1206,1.227,8.014,630,3.545,16.027,45,45,153
2018,45700,873,961,16551,16388,57,5.91,64,6.636,1742,463,1279,2.825,10.63,1403,333,1070,2.032,8.561,339,2.069,17.123,52,52,222
2018,45740,491,511,8247,8085,33,6.439,36,7.024,1006,111,895,1.373,12.444,669,159,510,1.967,8.275,337,4.168,16.55,29,29,139
2018,45780,9503,12311,269194,267093,864,6.996,941,7.62,33847,8351,25496,3.127,12.672,29905,8115,21790,3.038,11.196,3942,1.476,22.393,610,637,4350
2018,45820,3977,4713,84505,85065,298,6.281,361,7.609,8807,3709,5098,4.36,10.353,10015,2611,7404,3.069,11.773,-1208,-1.42,20.707,253,257,1152
2018,45860,3766,4186,51856,51170,318,7.559,360,8.557,6485,2166,4319,4.233,12.673,5086,1811,3275,3.539,9.939,1399,2.734,19.879,260,265,1363
2018,45900,3912,4380,58009,57607,323,7.366,333,7.594,6395,1815,4580,3.151,11.101,5581,1927,3654,3.345,9.688,814,1.413,19.376,251,252,1110
2018,45940,7506,8766,218007,216257,803,9.166,793,9.051,22682,5230,17452,2.418,10.488,18984,5674,13310,2.624,8.778,3698,1.71,17.557,590,596,2954
2018,45980,541,606,11739,11860,44,7.255,45,7.42,1087,186,901,1.568,9.166,1371,321,1050,2.707,11.56,-284,-2.395,18.331,34,34,232
2018,46020,2499,2680,29352,29101,304,11.411,272,10.21,3449,940,2509,3.23,11.852,2965,940,2025,3.23,10.189,484,1.663,20.378,211,211,653
2018,46060,14083,18318,327231,324142,1529,8.333,1589,8.66,37777,11398,26379,3.516,11.654,31608,9730,21878,3.002,9.751,6169,1.903,19.503,1141,1167,6354
2018,46100,1606,1874,33585,33456,123,6.558,126,6.718,2721,535,2186,1.599,8.133,2416,467,1949,1.396,7.222,305,0.912,14.443,96,96,303
2018,46140,17968,22374,418698,411797,1950,8.728,1886,8.442,60038,14929,45109,3.625,14.58,46324,12919,33405,3.137,11.249,13714,3.33,22.498,1405,1449,7317
2018,46180,2654,3137,66415,65958,203,6.486,189,6.038,7100,1507,5593,2.285,10.765,6199,1717,4482,2.603,9.398,901,1.366,18.797,144,144,1358
2018,46220,3623,4198,84178,84128,270,6.4,311,7.372,9274,1400,7874,1.664,11.024,9052,1944,7108,2.311,10.76,222,0.264,21.52,229,231,1238
2018,46300,2539,2854,38717,38770,277,9.783,232,8.194,4427,1594,2833,4.111,11.419,4524,1263,3261,3.258,11.669,-97,-0.25,22.837,190,192,933
2018,46340,4693,5458,93225,91360,535,9.915,411,7.617,14047,5817,8230,6.367,15.376,10301,3744,6557,4.098,11.275,3746,4.1,22.55,289,302,1722
2018,46380,2028,2229,23416,23319,175,7.846,178,7.98,2770,919,1851,3.941,11.879,2546,894,1652,3.834,10.918,224,0.961,21.837,148,149,700
2018,46460,637,716,10942,11037,45,6.294,43,6.014,854,301,553,2.727,7.738,1046,288,758,2.609,9.477,-192,-1.74,15.475,37,37,251
2018,46500,509,550,10685,10963,48,8.824,36,6.618,1231,270,961,2.463,11.229,1751,200,1551,1.824,15.973,-520,-4.743,22.458,24,26,80
2018,46520,15627,19853,390714,388284,1529,7.705,1514,7.629,42712,11669,31043,3.005,11,37594,11704,25890,3.014,9.682,5118,1.318,19.364,1105,1125,8130
2018,46540,4494,5386,101136,98544,378,6.997,410,7.59,14442,2085,12357,2.116,14.655,9734,2853,6881,2.895,9.878,4708,4.778,19.756,290,294,1626
2018,46620,551,600,7071,7067,40,6.7,34,5.695,666,198,468,2.802,9.425,659,168,491,2.377,9.326,7,0.099,18.651,27,27,152
2018,46660,2429,2916,44990,44671,217,7.475,191,6.579,4436,1381,3055,3.091,9.93,3799,973,2826,2.178,8.504,637,1.426,17.009,143,145,618
2018,46700,5487,6569,117421,115672,578,8.853,498,7.628,16577,5223,11354,4.515,14.331,13249,4212,9037,3.641,11.454,3328,2.877,22.908,359,361,2060
2018,46740,484,518,6898,6890,28,5.39,31,5.967,866,319,547,4.63,12.569,850,126,724,1.829,12.337,16,0.232,24.673,28,28,123
2018,46780,491,518,10256,10112,21,4.042,24,4.62,913,202,711,1.998,9.029,612,136,476,1.345,6.052,301,2.977,12.104,17,17,110
2018,46820,273,285,3839,3723,18,6.394,11,3.908,457,84,373,2.256,12.275,227,30,197,0.806,6.097,230,6.178,12.194,9,9,16
2018,46860,880,912,9093,9020,96,10.503,100,10.941,1385,398,987,4.412,15.355,1238,518,720,5.743,13.725,147,1.63,27.45,78,78,298
2018,46900,259,274,3248,3319,19,6.847,26,9.369,245,76,169,2.29,7.383,401,87,314,2.622,12.084,-156,-4.701,14.766,22,22,78
2018,46980,899,1026,17456,17667,69,6.732,67,6.537,1668,504,1164,2.853,9.442,2102,608,1494,3.442,11.898,-434,-2.457,18.883,35,36,258
2018,47020,2024,2285,34347,34093,185,8.125,169,7.422,4237,1199,3038,3.517,12.428,3722,1199,2523,3.517,10.917,515,1.511,21.834,123,123,879
2018,47080,657,717,10566,10779,43,5.943,56,7.74,997,168,829,1.559,9.25,1377,263,1114,2.44,12.775,-380,-3.526,18.5,41,42,114
2018,47180,724,803,14045,14261,45,5.528,67,8.231,1296,430,866,3.015,9.088,1737,441,1296,3.092,12.18,-441,-3.092,18.176,43,44,175
2018,47220,2266,2592,46428,46852,191,7.386,179,6.922,4961,1395,3566,2.977,10.589,5777,1480,4297,3.159,12.33,-816,-1.742,21.178,138,138,917
2018,47240,818,884,5808,5768,66,7.5,58,6.591,690,146,544,2.531,11.963,617,148,469,2.566,10.697,73,1.266,21.394,49,51,129
2018,47260,25702,34576,631181,626042,2921,8.46,2821,8.171,76895,23884,53011,3.815,12.283,66789,18532,48257,2.96,10.668,10106,1.614,21.337,1915,1987,10755
2018,47300,4980,5889,98436,97537,515,8.793,451,7.7,10821,3669,7152,3.762,11.094,8983,2415,6568,2.476,9.21,1838,1.884,18.42,345,351,1863
2018,47340,602,667,10857,10927,31,4.644,32,4.794,851,173,678,1.583,7.788,969,199,770,1.821,8.868,-118,-1.08,15.576,21,21,154
2018,47380,4305,5152,109033,107625,443,8.661,369,7.214,12770,3794,8976,3.525,11.865,9819,2426,7393,2.254,9.123,2951,2.742,18.247,279,286,1738
2018,47420,561,627,7664,7599,43,6.875,40,6.395,749,268,481,3.527,9.857,629,194,435,2.553,8.277,120,1.579,16.555,33,33,140
2018,47460,1242,1329,21349,21260,108,8.099,117,8.774,1907,581,1326,2.733,8.97,1723,453,1270,2.131,8.105,184,0.865,16.209,90,90,262
2018,47540,844,921,20800,20737,56,6.11,47,5.128,1493,282,1211,1.36,7.2,1364,177,1187,0.854,6.578,129,0.622,13.156,35,35,107
2018,47580,2444,2962,48556,48011,257,8.702,240,8.126,5533,1815,3718,3.78,11.524,4397,1354,3043,2.82,9.158,1136,2.366,18.317,171,172,938
2018,47620,662,834,13185,13540,39,4.659,45,5.376,766,153,613,1.13,5.657,1472,231,1241,1.706,10.871,-706,-5.214,11.315,35,35,196
2018,47660,738,814,10394,10412,69,8.354,93,11.259,1014,252,762,2.42,9.739,1046,403,643,3.871,10.046,-32,-0.307,19.478,65,65,216
2018,47700,1620,1829,38908,38389,123,6.756,106,5.823,4358,562,3796,1.464,11.352,3396,551,2845,1.435,8.846,962,2.506,17.693,86,89,437
2018,47780,813,863,10631,10685,57,6.609,56,6.493,1190,315,875,2.948,11.138,1301,475,826,4.446,12.177,-111,-1.039,22.275,44,47,351
2018,47820,902,1017,14394,13997,75,7.407,66,6.519,2010,685,1325,4.894,14.36,1239,484,755,3.458,8.852,771,5.508,17.704,48,52,360
2018,47900,107175,140263,2754173,2724686,13117,9.377,12349,8.828,344988,99679,245309,3.658,12.662,285212,87588,197624,3.215,10.468,59776,2.194,20.935,8350,8564,45306
2018,47920,501,558,10456,10200,27,4.783,40,7.086,1364,519,845,5.088,13.373,876,203,673,1.99,8.589,488,4.785,17.177,19,20,83
2018,47940,3029,3763,75385,75398,245,6.498,260,6.896,7274,1968,5306,2.61,9.647,7224,1561,5663,2.07,9.581,50,0.066,19.162,181,183,931
2018,47980,938,1004,13717,13594,64,6.378,63,6.278,1392,326,1066,2.398,10.24,1087,341,746,2.508,7.996,305,2.244,15.992,51,51,256
2018,48020,1629,1845,30334,30247,112,6.067,114,6.176,3404,871,2533,2.88,11.254,3251,710,2541,2.347,10.748,153,0.506,21.497,78,78,432
2018,48060,1790,2154,29542,29676,184,8.586,162,7.559,2841,920,1921,3.1,9.573,3068,881,2187,2.969,10.338,-227,-0.765,19.147,110,112,545
2018,48100,333,363,4680,4425,31,8.575,28,7.746,1251,958,293,21.65,28.271,740,494,246,11.164,16.723,511,11.548,33.446,23,23,485
2018,48140,2669,3178,65994,65520,193,6.086,179,5.645,5661,1436,4225,2.192,8.64,4684,1451,3233,2.215,7.149,977,1.491,14.298,132,132,588
2018,48180,1003,1110,14901,14867,86,7.734,90,8.094,1878,688,1190,4.628,12.632,1776,862,914,5.798,11.946,102,0.686,23.893,60,74,638
2018,48220,756,834,10068,9766,59,7.057,63,7.536,1503,220,1283,2.253,15.39,892,308,584,3.154,9.134,611,6.256,18.267,51,51,230
2018,48260,1686,2003,33614,33602,108,5.361,131,6.503,3211,722,2489,2.149,9.556,3198,1026,2172,3.053,9.517,13,0.039,19.035,94,95,448
2018,48300,2752,2977,37718,36786,278,9.395,242,8.178,5056,1356,3700,3.686,13.744,3201,985,2216,2.678,8.702,1855,5.043,17.403,189,191,675
2018,48460,900,1002,12488,12465,84,8.421,75,7.519,1360,290,1070,2.327,10.911,1308,252,1056,2.022,10.493,52,0.417,20.987,61,61,146
2018,48540,2444,3071,55709,55168,151,4.872,208,6.711,6233,1829,4404,3.315,11.298,5136,1219,3917,2.21,9.31,1097,1.988,18.62,147,149,782
2018,48580,2274,2492,37800,36608,216,8.711,191,7.703,5888,2228,3660,6.086,16.084,3597,1157,2440,3.161,9.826,2291,6.258,19.652,144,148,876
2018,48620,10738,13765,265959,266245,1044,7.575,1080,7.836,27493,7625,19868,2.864,10.326,28094,7338,20756,2.756,10.552,-601,-0.226,20.652,808,841,5130
2018,48660,2803,3178,47561,47152,230,7.221,244,7.661,5199,1176,4023,2.494,11.026,4346,1449,2897,3.073,9.217,853,1.809,18.434,196,196,1253
2018,48700,2172,2535,44872,44367,160,6.3,169,6.655,4874,1369,3505,3.086,10.986,3822,1001,2821,2.256,8.615,1052,2.371,17.229,113,115,468
2018,48780,1209,1360,20966,20123,172,12.836,132,9.851,4104,788,3316,3.916,20.395,2372,1246,1126,6.192,11.788,1732,8.607,23.576,93,94,360
2018,48820,1101,1290,18967,19055,79,6.162,63,4.914,2776,1473,1303,7.73,14.568,3002,531,2471,2.787,15.754,-226,-1.186,29.137,49,49,421
2018,48900,6868,7922,112192,110342,800,10.242,578,7.4,15523,5936,9587,5.38,14.068,11809,3395,8414,3.077,10.702,3714,3.366,21.404,425,432,1975
2018,48940,613,675,15154,15766,40,5.857,56,8.199,1442,194,1248,1.23,9.146,2646,1435,1211,9.102,16.783,-1204,-7.637,18.293,41,42,540
2018,48980,1410,1588,31644,31326,86,5.377,109,6.815,3468,722,2746,2.305,11.071,2771,852,1919,2.72,8.846,697,2.225,17.691,82,82,533
2018,49020,2602,2994,55381,55218,231,7.752,203,6.812,5955,1413,4542,2.559,10.785,5578,1250,4328,2.264,10.102,377,0.683,20.204,156,159,983
2018,49080,351,366,5675,5862,25,6.812,27,7.357,325,63,262,1.075,5.544,695,111,584,1.894,11.856,-370,-6.312,11.088,22,22,90
2018,49100,924,1063,23804,22599,65,6.132,59,5.566,3937,379,3558,1.677,17.421,1424,324,1100,1.434,6.301,2513,11.12,12.602,36,36,185
2018,49180,10138,12343,251871,248690,1046,8.511,939,7.641,30874,7904,22970,3.178,12.415,24196,8076,16120,3.247,9.729,6678,2.685,19.459,666,680,5408
2018,49220,1442,1652,37734,37387,92,5.552,102,6.156,4044,696,3348,1.862,10.817,3383,1474,1909,3.943,9.049,661,1.768,18.097,77,77,522
2018,49260,646,700,7438,7362,59,8.447,56,8.017,905,180,725,2.445,12.294,729,264,465,3.586,9.903,176,2.391,19.806,36,36,159
2018,49300,2081,2358,42192,41431,128,5.413,141,5.963,4836,796,4040,1.921,11.672,3374,808,2566,1.95,8.144,1462,3.529,16.287,107,107,507
2018,49340,15274,18575,345544,342194,1596,8.61,1519,8.195,41810,11017,30793,3.22,12.218,35249,11333,23916,3.312,10.301,6561,1.917,20.602,1087,1110,5978
2018,49380,505,559,8718,8724,44,7.921,37,6.661,714,240,474,2.751,8.185,703,197,506,2.258,8.059,11,0.126,16.117,22,22,135
2018,49420,3760,4342,73852,72075,380,8.79,342,7.911,10190,3873,6317,5.374,14.138,6498,2364,4134,3.28,9.016,3692,5.122,18.031,271,273,1470
2018,49460,625,668,11645,11445,40,5.904,59,8.708,1167,193,974,1.686,10.197,753,309,444,2.7,6.579,414,3.617,13.159,46,46,242
2018,49620,6382,8046,170547,169496,521,6.461,557,6.907,15851,3299,12552,1.946,9.352,13647,3273,10374,1.931,8.052,2204,1.3,16.103,400,414,1946
2018,49660,8911,11188,193256,193960,687,6.124,746,6.65,20552,7095,13457,3.658,10.596,21953,4355,17598,2.245,11.318,-1401,-0.722,21.192,525,533,2980
2018,49700,2114,2385,32652,32396,242,10.269,185,7.851,4043,1387,2656,4.281,12.48,3604,996,2608,3.074,11.125,439,1.355,22.25,145,145,648
2018,49740,2324,2793,45119,45019,218,7.805,218,7.805,5150,1639,3511,3.641,11.44,4934,1679,3255,3.73,10.96,216,0.48,21.92,157,158,699
2018,49780,1369,1591,28502,28468,97,6.066,113,7.067,2681,609,2072,2.139,9.418,2567,823,1744,2.891,9.017,114,0.4,18.034,81,81,351
2018,49820,124,127,1610,1537,9,7.004,12,9.339,287,116,171,7.55,18.679,149,62,87,4.035,9.697,138,8.981,19.395,7,7,20
